平安银行股份有限公司	平安银行
万科企业股份有限公司	万科Ａ
万科企业股份有限公司	万科Ａ
深圳中国农大科技股份有限公司	国农科技
深圳世纪星源股份有限公司	世纪星源
深圳市振业(集团)股份有限公司	深振业Ａ
深圳市零七股份有限公司	零七股份
广东宝利来投资股份有限公司	宝利来
中国宝安集团股份有限公司	中国宝安
北京深华新股份有限公司	深华新
深圳市物业发展(集团)股份有限公司	深物业Ａ
深圳市物业发展(集团)股份有限公司	深物业Ａ
中国南玻集团股份有限公司	南玻Ａ
中国南玻集团股份有限公司	南玻Ａ
沙河实业股份有限公司	沙河股份
康佳集团股份有限公司	深康佳Ａ
康佳集团股份有限公司	深康佳Ａ
深圳中华自行车(集团)股份有限公司	深中华
深圳中华自行车(集团)股份有限公司	深中华
深圳中冠纺织印染股份有限公司	深中冠Ａ
深圳中冠纺织印染股份有限公司	深中冠Ａ
深圳市深宝实业股份有限公司	深深宝Ａ
深圳市深宝实业股份有限公司	深深宝Ａ
深圳中恒华发股份有限公司	深华发
深圳中恒华发股份有限公司	深华发
深圳长城开发科技股份有限公司	长城开发
深圳赤湾港航股份有限公司	深赤湾Ａ
深圳赤湾港航股份有限公司	深赤湾Ａ
深圳市天地(集团)股份有限公司	深天地Ａ
招商局地产控股股份有限公司	招商地产
招商局地产控股股份有限公司	招商地产
深圳市特力(集团)股份有限公司	深特力
深圳市特力(集团)股份有限公司	深特力
飞亚达(集团)股份有限公司	飞亚达Ａ
飞亚达(集团)股份有限公司	飞亚达Ａ
深圳能源集团股份有限公司	深圳能源
国药集团一致药业股份有限公司	国药一致
国药集团一致药业股份有限公司	国药一致
深圳经济特区房地产(集团)股份有限公司	深深房Ａ
深圳经济特区房地产(集团)股份有限公司	深深房Ａ
富奥汽车零部件股份有限公司	NULL
富奥汽车零部件股份有限公司	NULL
中粮地产(集团)股份有限公司	中粮地产
深圳市桑达实业股份有限公司	深桑达Ａ
深圳新都酒店股份有限公司	新都酒店
深圳市深信泰丰(集团)股份有限公司	深信泰丰
中国科健股份有限公司	中科健
华联控股股份有限公司	华联控股
深圳南山热电股份有限公司	深南电Ａ
深圳南山热电股份有限公司	深南电Ａ
深圳大通实业股份有限公司	深大通Ａ
中国国际海运集装箱(集团)股份有限公司	中集集团
中国国际海运集装箱(集团)股份有限公司	中集集团
宝安鸿基地产集团股份有限公司	宝安地产
深圳市长城投资控股股份有限公司	深长城
中航地产股份有限公司	中航地产
深圳市纺织(集团)股份有限公司	深纺织Ａ
深圳市纺织(集团)股份有限公司	深纺织Ａ
泛海建设集团股份有限公司	泛海建设
深圳市康达尔(集团)股份有限公司	康达尔
深圳市德赛电池科技股份有限公司	德赛电池
天马微电子股份有限公司	深天马Ａ
方大集团股份有限公司	方大集团
方大集团股份有限公司	方大集团
深圳市国际企业股份有限公司	深国商Ａ
深圳市国际企业股份有限公司	深国商Ａ
深圳赛格股份有限公司	深赛格
深圳赛格股份有限公司	深赛格
辽宁华锦通达化工股份有限公司	辽通化工
深圳市中金岭南有色金属股份有限公司	中金岭南
深圳市农产品股份有限公司	农产品
深圳华强实业股份有限公司	深圳华强
中兴通讯股份有限公司	中兴通讯
北方国际合作股份有限公司	北方国际
中国长城计算机深圳股份有限公司	长城电脑
深圳华控赛格股份有限公司	华控赛格
深圳华侨城股份有限公司	华侨城Ａ
深圳市特发信息股份有限公司	特发信息
深圳市海王生物工程股份有限公司	海王生物
深圳市盐田港股份有限公司	盐田港
深圳市机场股份有限公司	深圳机场
深圳市天健(集团)股份有限公司	深天健
深圳市广聚能源股份有限公司	广聚能源
中信海洋直升机股份有限公司	中信海直
TCL集团股份有限公司	TCL集团
宜华地产股份有限公司	宜华地产
中成进出口股份有限公司	中成股份
安徽丰原药业股份有限公司	丰原药业
川化股份有限公司	川化股份
华数传媒控股股份有限公司	华数传媒
中联重科股份有限公司	中联重科
石家庄常山纺织股份有限公司	常山股份
新疆国际实业股份有限公司	国际实业
江苏吴江中国东方丝绸市场股份有限公司	东方市场
许继电气股份有限公司	许继电气
唐山冀东水泥股份有限公司	冀东水泥
金融街控股股份有限公司	金融街
振兴生化股份有限公司	三九生化
华意压缩机股份有限公司	华意压缩
中国石化胜利油田大明(集团)股份有限公司	石油大明
山东胜利股份有限公司	胜利股份
金谷源控股股份有限公司	金谷源
山东地矿股份有限公司	山东地矿
沈阳机床股份有限公司	沈阳机床
浙江英特集团股份有限公司	英特集团
东旭光电科技股份有限公司	东旭光电
东旭光电科技股份有限公司	东旭光电
渤海租赁股份有限公司	渤海租赁
民生投资管理股份有限公司	民生投资
合肥百货大楼集团股份有限公司	合肥百货
无锡小天鹅股份有限公司	小天鹅Ａ
无锡小天鹅股份有限公司	小天鹅Ａ
长沙通程控股股份有限公司	通程控股
吉林化纤股份有限公司	吉林化纤
南京中北(集团)股份有限公司	南京中北
湖北宜化化工股份有限公司	湖北宜化
山东东阿阿胶股份有限公司	东阿阿胶
徐工集团工程机械股份有限公司	徐工机械
内蒙古兴业矿业股份有限公司	兴业矿业
华天酒店集团股份有限公司	华天酒店
广东省高速公路发展股份有限公司	粤高速Ａ
广东省高速公路发展股份有限公司	粤高速Ａ
张家界旅游集团股份有限公司	张家界
山东晨鸣纸业集团股份有限公司	晨鸣纸业
山东晨鸣纸业集团股份有限公司	晨鸣纸业
山东高速路桥集团股份有限公司	路桥集团
武汉武商集团股份有限公司	鄂武商Ａ
绿景控股股份有限公司	绿景控股
海虹企业(控股)股份有限公司	海虹控股
北京赛迪传媒投资股份有限公司	赛迪传媒
海南珠江控股股份有限公司	珠江控股
海南珠江控股股份有限公司	珠江控股
中润资源投资股份有限公司	中润资源
珠海港股份有限公司	珠海港
海南民源现代农业发展股份有限公司	琼民源Ａ
华塑控股股份有限公司	华塑控股
四川金路集团股份有限公司	金路集团
沈阳银基发展股份有限公司	银基发展
丽珠医药集团股份有限公司	丽珠集团
丽珠医药集团股份有限公司	丽珠集团
重庆渝开发股份有限公司	渝开发
攀钢集团重庆钛业股份有限公司	攀渝钛业
西安开元投资集团股份有限公司	开元投资
荣安地产股份有限公司	荣安地产
江苏四环生物股份有限公司	四环生物
湖南江南红箭股份有限公司	江南红箭
长航凤凰股份有限公司	长航凤凰
合肥美菱股份有限公司	美菱电器
合肥美菱股份有限公司	美菱电器
广州白云山制药股份有限公司	白云山Ａ
广州市浪奇实业股份有限公司	广州浪奇
广州市东方宾馆股份有限公司	东方宾馆
南京红太阳股份有限公司	红太阳
厦门银润投资股份有限公司	银润投资
广东美的电器股份有限公司	美的电器
广西柳工机械股份有限公司	桂柳工Ａ
广东广弘控股股份有限公司	广弘控股
大连冷冻机股份有限公司	大冷股份
大连冷冻机股份有限公司	大冷股份
广州恒运企业集团股份有限公司	穗恒运Ａ
力合股份有限公司	力合股份
广东万家乐股份有限公司	万家乐
万泽实业股份有限公司	万泽股份
华映科技(集团)股份有限公司	华映科技
天津广宇发展股份有限公司	广宇发展
云南白药集团股份有限公司	云南白药
广东电力发展股份有限公司	粤电力Ａ
广东电力发展股份有限公司	粤电力Ａ
中天城投集团股份有限公司	中天城投
佛山电器照明股份有限公司	佛山照明
佛山电器照明股份有限公司	佛山照明
TCL通讯设备股份有限公司	TCL通讯
安徽省皖能股份有限公司	皖能电力
中原环保股份有限公司	中原环保
吉林金浦钛业股份有限公司	金浦钛业
吉林光华控股集团股份有限公司	光华控股
神州学人集团股份有限公司	闽福发Ａ
湖南投资集团股份有限公司	湖南投资
湘火炬汽车集团股份有限公司	湘火炬Ａ
江铃汽车股份有限公司	江铃汽车
江铃汽车股份有限公司	江铃汽车
创元科技股份有限公司	创元科技
甘肃靖远煤电股份有限公司	靖远煤电
湖北沙隆达股份有限公司	沙隆达Ａ
湖北沙隆达股份有限公司	沙隆达Ａ
中国石化山东泰山石油股份有限公司	泰山石油
深圳市太光电信股份有限公司	太光电信
广夏(银川)实业股份有限公司	银广夏
莱茵达置业股份有限公司	莱茵置业
万向钱潮股份有限公司	万向钱潮
昆明百货大楼(集团)股份有限公司	昆百大
陕西烽火电子股份有限公司	烽火电子
宏源证券股份有限公司	宏源证券
陕西省国际信托股份有限公司	陕国投
西安民生集团股份有限公司	西安民生
重庆三峡油漆股份有限公司	渝三峡Ａ
海南海药股份有限公司	海南海药
海南海德实业股份有限公司	海德股份
泸州老窖股份有限公司	泸州老窖
攀钢集团四川长城特殊钢股份有限公司	长城股份
常柴股份有限公司	苏常柴Ａ
常柴股份有限公司	苏常柴Ａ
新大洲控股股份有限公司	新大洲Ａ
海马汽车集团股份有限公司	海马汽车
东莞宏远工业区股份有限公司	粤宏远Ａ
江门甘蔗化工厂(集团)股份有限公司	广东甘化
青海盐湖工业集团股份有限公司	盐湖集团
无锡威孚高科技集团股份有限公司	威孚高科
无锡威孚高科技集团股份有限公司	威孚高科
北海港股份有限公司	北海港
四川友利投资控股股份有限公司	友利控股
东北电气发展股份有限公司	东北电气
四川汇源光通信股份有限公司	汇源通信
金叶珠宝股份有限公司	金叶珠宝
贵州轮胎股份有限公司	黔轮胎Ａ
紫光古汉集团股份有限公司	紫光古汉
重庆桐君阁股份有限公司	桐君阁
福建中福实业股份有限公司	中福实业
四川大通燃气开发股份有限公司	大通燃气
天津国恒铁路控股股份有限公司	国恒铁路
西北轴承股份有限公司	西北轴承
安徽古井贡酒股份有限公司	古井贡酒
安徽古井贡酒股份有限公司	古井贡酒
东北制药集团股份有限公司	东北制药
成都市兴蓉投资股份有限公司	兴蓉投资
青岛双星股份有限公司	青岛双星
河北建投能源投资股份有限公司	建投能源
广东韶能集团股份有限公司	韶能股份
广东金马旅游集团股份有限公司	金马集团
盛达矿业股份有限公司	盛达矿业
四环药业股份有限公司	四环药业
青海明胶股份有限公司	青海明胶
浙江华智控股股份有限公司	华智控股
阳光新业地产股份有限公司	阳光股份
北京绵世投资集团股份有限公司	绵世股份
西安旅游股份有限公司	西安旅游
内蒙古四海科技股份有限公司	四海股份
焦作万方铝业股份有限公司	焦作万方
海南大东海旅游中心股份有限公司	大东海
海南大东海旅游中心股份有限公司	大东海
湖北金环股份有限公司	湖北金环
亿城集团股份有限公司	亿城股份
济南柴油机股份有限公司	石油济柴
吉林化学工业股份有限公司	吉林化工
芜湖海螺型材科技股份有限公司	海螺型材
新华联不动产股份有限公司	新华联
岳阳恒立冷气设备股份有限公司	岳阳恒立
吉林敖东药业集团股份有限公司	吉林敖东
重庆长安汽车股份有限公司	长安汽车
重庆长安汽车股份有限公司	长安汽车
连云港如意集团股份有限公司	如意集团
天茂实业集团股份有限公司	天茂集团
成都高新发展股份有限公司	高新发展
攀钢集团钒钛资源股份有限公司	NULL
铜陵有色金属集团股份有限公司	铜陵有色
顺发恒业股份公司	顺发恒业
福建三木集团股份有限公司	三木集团
沈阳合金投资股份有限公司	合金投资
宁夏英力特化工股份有限公司	英力特
广东风华高新科技股份有限公司	风华高科
茂名石化实华股份有限公司	茂化实华
万方城镇投资发展股份有限公司	万方发展
西王食品股份有限公司	西王食品
仁和药业股份有限公司	仁和药业
珠海格力电器股份有限公司	格力电器
天津泰达股份有限公司	泰达股份
山东金岭矿业股份有限公司	金岭矿业
金科地产集团股份有限公司	金科股份
中钨高新材料股份有限公司	中钨高新
珠海中富实业股份有限公司	珠海中富
长春高新技术产业(集团)股份有限公司	长春高新
索芙特股份有限公司	索芙特
福建省永安林业(集团)股份有限公司	永安林业
湖北省广播电视信息网络股份有限公司	湖北广电
经纬纺织机械股份有限公司	经纬纺机
名流置业集团股份有限公司	名流置业
荣丰控股集团股份有限公司	荣丰控股
中油金鸿能源投资股份有限公司	金鸿能源
舜元实业发展股份有限公司	NULL
阳光城集团股份有限公司	阳光城
甘肃上峰水泥股份有限公司	上峰水泥
当代东方投资股份有限公司	当代东方
河南思达高科技股份有限公司	思达高科
恒天海龙股份有限公司	恒天海龙
襄阳汽车轴承股份有限公司	襄阳轴承
大连友谊(集团)股份有限公司	大连友谊
山推工程机械股份有限公司	山推股份
远东实业股份有限公司	远东股份
东方电子股份有限公司	东方电子
内蒙古远兴能源股份有限公司	远兴能源
中山公用事业集团股份有限公司	中山公用
东北证券股份有限公司	东北证券
恒天天鹅股份有限公司	恒天天鹅
建新矿业股份有限责任公司	建新矿业
广东宝丽华新能源股份有限公司	宝新能源
海南亚太实业发展股份有限公司	亚太实业
沈阳惠天热电股份有限公司	惠天热电
成都华泽钴镍材料股份有限公司	华泽钴镍
天津滨海能源发展股份有限公司	滨海能源
重庆宗申动力机械股份有限公司	宗申动力
陕西炼石有色资源股份有限公司	炼石有色
沈阳化工股份有限公司	沈阳化工
江南模塑科技股份有限公司	模塑科技
厦门信达股份有限公司	厦门信达
湖南正虹科技发展股份有限公司	正虹科技
恒逸石化股份有限公司	恒逸石化
浙江震元股份有限公司	浙江震元
湖北双环科技股份有限公司	双环科技
大冶特殊钢股份有限公司	大冶特钢
河北钢铁股份有限公司	河北钢铁
成都天兴仪表股份有限公司	天兴仪表
黑龙江天伦置业股份有限公司	天伦置业
广东锦龙发展股份有限公司	锦龙股份
合肥丰乐种业股份有限公司	丰乐种业
中兴-沈阳商业大厦(集团)股份有限公司	中兴商业
南方黑芝麻集团股份有限公司	南方食品
广东韶钢松山股份有限公司	韶钢松山
苏宁环球股份有限公司	苏宁环球
中原大地传媒股份有限公司	大地传媒
山东新能泰山发电股份有限公司	新能泰山
西安饮食股份有限公司	西安饮食
湖南发展集团股份有限公司	湖南发展
山西美锦能源股份有限公司	美锦能源
京东方科技集团股份有限公司	京东方Ａ
京东方科技集团股份有限公司	京东方Ａ
鲁泰纺织股份有限公司	鲁泰Ａ
鲁泰纺织股份有限公司	鲁泰Ａ
南京华东电子信息科技股份有限公司	华东科技
国元证券股份有限公司	国元证券
北京燕京啤酒股份有限公司	燕京啤酒
四川美丰化工股份有限公司	四川美丰
泰禾集团股份有限公司	泰禾集团
中国振华(集团)科技股份有限公司	振华科技
罗牛山股份有限公司	罗牛山
中房地产股份有限公司	中房地产
南风化工集团股份有限公司	南风化工
中航动力控制股份有限公司	中航动控
普洛药业股份有限公司	普洛药业
长城信息产业股份有限公司	长城信息
国海证券股份有限公司	国海证券
葫芦岛锌业股份有限公司	锌业股份
西藏银河科技发展股份有限公司	西藏发展
福建漳州发展股份有限公司	漳州发展
山西三维集团股份有限公司	山西三维
山东新华制药股份有限公司	新华制药
四川浩物机电股份有限公司	浩物机电
中国有色金属建设股份有限公司	中色股份
中百控股集团股份有限公司	中百集团
湖北博盈投资股份有限公司	博盈投资
本钢板材股份有限公司	本钢板材
本钢板材股份有限公司	本钢板材
西藏矿业发展股份有限公司	西藏矿业
锦州石化股份有限公司	锦州石化
通化金马药业集团股份有限公司	通化金马
山西漳泽电力股份有限公司	漳泽电力
中航飞机股份有限公司	中航飞机
广发证券股份有限公司	广发证券
中核苏阀科技实业股份有限公司	中核科技
新兴铸管股份有限公司	新兴铸管
兰州三毛实业股份有限公司	三毛派神
内蒙古平庄能源股份有限公司	平庄能源
广东新会美达锦纶股份有限公司	美达股份
长江证券股份有限公司	长江证券
武汉中商集团股份有限公司	武汉中商
北新集团建材股份有限公司	北新建材
北大医药股份有限公司	NULL
江西万年青水泥股份有限公司	江西水泥
成都华神集团股份有限公司	华神集团
甘肃电投能源发展股份有限公司	甘肃电投
青海盐湖工业股份有限公司	盐湖股份
华闻传媒投资集团股份有限公司	华闻传媒
太原双塔刚玉股份有限公司	太原刚玉
易食集团股份有限公司	易食股份
中国武夷实业股份有限公司	中国武夷
中水集团远洋股份有限公司	中水渔业
酒鬼酒股份有限公司	酒鬼酒
一汽轿车股份有限公司	一汽轿车
四川九洲电器股份有限公司	四川九洲
北京京西风光旅游开发股份有限公司	北京旅游
四川金宇汽车城(集团)股份有限公司	金宇车城
江苏炎黄在线物流股份有限公司	炎黄物流
北海银河产业投资股份有限公司	银河产投
云南铝业股份有限公司	云铝股份
铁岭新城投资控股股份有限公司	铁岭新城
华润锦华股份有限公司	华润锦华
烟台冰轮股份有限公司	烟台冰轮
陕西金叶科教集团股份有限公司	陕西金叶
新疆天山毛纺织股份有限公司	天山纺织
中冶美利纸业股份有限公司	美利纸业
江苏江淮动力股份有限公司	江淮动力
辽河金马油田股份有限公司	辽河油田
方大锦化化工科技股份有限公司	方大化工
岳阳兴长石化股份有限公司	岳阳兴长
金城造纸股份有限公司	金城股份
湖北京山轻工机械股份有限公司	京山轻机
山东海化股份有限公司	山东海化
广东汕头超声电子股份有限公司	超声电子
山西太钢不锈钢股份有限公司	太钢不锈
桑德环境资源股份有限公司	桑德环境
东莞发展控股股份有限公司	东莞控股
天音通信控股股份有限公司	天音控股
鲁西化工集团股份有限公司	鲁西化工
五矿稀土股份有限公司	五矿稀土
广西贵糖(集团)股份有限公司	贵糖股份
四川圣达实业股份有限公司	四川圣达
天津鑫茂科技股份有限公司	鑫茂科技
陕西秦川机械发展股份有限公司	秦川发展
国兴融达地产股份有限公司	国兴地产
中信国安信息产业股份有限公司	中信国安
河北承德露露股份有限公司	承德露露
安徽华茂纺织股份有限公司	华茂股份
大唐高鸿数据网络技术股份有限公司	高鸿股份
江汉石油钻头股份有限公司	江钻股份
唐山冀东装备工程股份有限公司	冀东装备
宜宾五粮液股份有限公司	五粮液
安徽国风塑业股份有限公司	国风塑业
北京顺鑫农业股份有限公司	顺鑫农业
广东海印集团股份有限公司	海印股份
宁夏银星能源股份有限公司	银星能源
三湘股份有限公司	三湘股份
中国石化扬子石油化工股份有限公司	扬子石化
安徽安凯汽车股份有限公司	安凯客车
烟台张裕葡萄酿酒股份有限公司	张裕Ａ
烟台张裕葡萄酿酒股份有限公司	张裕Ａ
吉林电力股份有限公司	吉电股份
新希望六和股份有限公司	新希望
新疆天山水泥股份有限公司	天山股份
云南铜业股份有限公司	云南铜业
潍柴重机股份有限公司	潍柴重机
中国大连国际合作(集团)股份有限公司	大连国际
北京华联商厦股份有限公司	华联股份
湖北能源集团股份有限公司	湖北能源
河南同力水泥股份有限公司	同力水泥
海南高速公路股份有限公司	海南高速
安徽中鼎密封件股份有限公司	中鼎股份
峨眉山旅游股份有限公司	峨眉山Ａ
茂业物流股份有限公司	茂业物流
江苏法尔胜股份有限公司	法尔胜
星美联合股份有限公司	星美联合
广州东凌粮油股份有限公司	东凌粮油
河南双汇投资发展股份有限公司	双汇发展
河南豫能控股股份有限公司	豫能控股
天津津滨发展股份有限公司	津滨发展
鞍钢股份有限公司	鞍钢股份
江西赣能股份有限公司	赣能股份
现代投资股份有限公司	现代投资
航天科技控股集团股份有限公司	航天科技
中国服装股份有限公司	中国服装
昆明云内动力股份有限公司	云内动力
厦门港务发展股份有限公司	厦门港务
物产中拓股份有限公司	物产中拓
湖南天一科技股份有限公司	天一科技
数源科技股份有限公司	数源科技
大亚科技股份有限公司	大亚科技
南宁糖业股份有限公司	南宁糖业
四川泸天化股份有限公司	泸天化
浙江钱江摩托股份有限公司	钱江摩托
山东山大华特科技股份有限公司	山大华特
华北高速公路股份有限公司	华北高速
湖南电广传媒股份有限公司	电广传媒
嘉凯城集团股份有限公司	嘉凯城
金陵药业股份有限公司	金陵药业
南方汇通股份有限公司	南方汇通
海信科龙电器股份有限公司	海信科龙
哈尔滨电气集团佳木斯电机股份有限公司	阿继电器
河北宣化工程机械股份有限公司	河北宣工
浙江众合机电股份有限公司	众合机电
湖北福星科技股份有限公司	福星股份
天津一汽夏利汽车股份有限公司	一汽夏利
中钢集团吉林炭素股份有限公司	中钢吉炭
兰州黄河企业股份有限公司	兰州黄河
中粮生物化学(安徽)股份有限公司	中粮生化
北京中关村科技发展(控股)股份有限公司	中关村
湖南华菱钢铁股份有限公司	华菱钢铁
河南神火煤电股份有限公司	神火股份
四川双马水泥股份有限公司	四川双马
江苏华西村股份有限公司	华西股份
冀中能源股份有限公司	冀中能源
紫光股份有限公司	紫光股份
武汉凯迪电力股份有限公司	凯迪电力
云南南天电子信息产业股份有限公司	南天信息
新乡化纤股份有限公司	新乡化纤
重庆建峰化工股份有限公司	建峰化工
中国重汽集团济南卡车股份有限公司	中国重汽
湖北广济药业股份有限公司	广济药业
广西河池化工股份有限公司	河池化工
欣龙控股(集团)股份有限公司	欣龙控股
中国石化中原油气高新股份有限公司	中原油气
中通客车控股股份有限公司	中通客车
石家庄东方热电股份有限公司	东方热电
北京首钢股份有限公司	首钢股份
云南锡业股份有限公司	锡业股份
江苏中南建设集团股份有限公司	中南建设
宁夏东方钽业股份有限公司	东方钽业
华东医药股份有限公司	华东医药
天津天保基建股份有限公司	天保基建
国电长源电力股份有限公司	长源电力
浙江上风实业股份有限公司	上风高科
太原煤气化股份有限公司	煤气化
安泰科技股份有限公司	安泰科技
北京中科三环高技术股份有限公司	中科三环
湖北蓝鼎控股股份有限公司	蓝鼎控股
新疆中基实业股份有限公司	新中基
佛山佛塑科技集团股份有限公司	佛塑科技
银泰资源股份有限公司	银泰资源
广东开平春晖股份有限公司	春晖股份
浪潮电子信息产业股份有限公司	浪潮信息
桂林旅游股份有限公司	桂林旅游
中弘控股股份有限公司	中弘股份
黄山金马股份有限公司	金马股份
银亿房地产股份有限公司	银亿股份
宁夏中银绒业股份有限公司	中银绒业
山西西山煤电股份有限公司	西山煤电
大庆华科股份有限公司	大庆华科
广州友谊集团股份有限公司	广州友谊
华工科技产业股份有限公司	华工科技
九芝堂股份有限公司	九芝堂
诚志股份有限公司	诚志股份
福建闽东电力股份有限公司	闽东电力
甘肃皇台酒业股份有限公司	皇台酒业
中国中期投资股份有限公司	中国中期
福建新大陆电脑股份有限公司	新大陆
袁隆平农业高科技股份有限公司	隆平高科
华润三九医药股份有限公司	华润三九
浙江新和成股份有限公司	Ｇ新和成
深圳赤湾石油基地股份有限公司	深基地Ｂ
重庆建设摩托车股份有限公司	建摩Ｂ
山东航空股份有限公司	山航Ｂ
承德南江股份有限公司	南江股份
广东雷伊(集团)股份有限公司	雷伊Ｂ
南京普天通信股份有限公司	宁通信Ｂ
厦门灿坤实业股份有限公司	闽灿坤Ｂ
瓦房店轴承股份有限公司	瓦轴Ｂ
武汉锅炉股份有限公司	武锅Ｂ
杭州汽轮机股份有限公司	杭汽轮Ｂ
佛山华新包装股份有限公司	粤华包Ｂ
山东省中鲁远洋渔业股份有限公司	中鲁远洋
广东广州日报传媒股份有限公司	粤传媒
上海浦东发展银行股份有限公司	浦发银行
邯郸钢铁股份有限公司	邯郸钢铁
中国石化齐鲁股份有限公司	齐鲁石化
东北高速公路股份有限公司	东北高速
广州白云国际机场股份有限公司	白云机场
武汉钢铁股份有限公司	武钢股份
东风汽车股份有限公司	东风汽车
中国国际贸易中心股份有限公司	中国国贸
北京首创股份有限公司	首创股份
上海国际机场股份有限公司	上海机场
内蒙古包钢钢联股份有限公司	包钢股份
华能国际电力股份有限公司	华能国际
安徽皖通高速公路股份有限公司	皖通高速
华夏银行股份有限公司	华夏银行
中国民生银行股份有限公司	民生银行
上海港集装箱股份有限公司	上港集箱
宝山钢铁股份有限公司	宝钢股份
河南中原高速公路股份有限公司	中原高速
上海电力股份有限公司	上海电力
中海发展股份有限公司	中海发展
中国石油化工股份有限公司	中国石化
中国南方航空股份有限公司	南方航空
中信证券股份有限公司	中信证券
三一重工股份有限公司	三一重工
福建发展高速公路股份有限公司	福建高速
湖北楚天高速公路股份有限公司	楚天高速
招商银行股份有限公司	招商银行
北京歌华有线电视网络股份有限公司	歌华有线
哈飞航空工业股份有限公司	哈飞股份
四川路桥建设股份有限公司	四川路桥
中国联合网络通信股份有限公司	中国联通
宁波联合集团股份有限公司	宁波联合
浙江广厦股份有限公司	浙江广厦
江西中江地产股份有限公司	中江地产
黄山旅游发展股份有限公司	黄山旅游
黄山旅游发展股份有限公司	黄山旅游
华润万东医疗装备股份有限公司	华润万东
中国医药保健品股份有限公司	中国医药
厦门象屿股份有限公司	象屿股份
五矿发展股份有限公司	五矿发展
浙江古越龙山绍兴酒股份有限公司	古越龙山
青岛海信电器股份有限公司	海信电器
中纺投资发展股份有限公司	中纺投资
华润双鹤药业股份有限公司	华润双鹤
安徽皖维高新材料股份有限公司	皖维高新
南京高科股份有限公司	南京高科
郑州宇通客车股份有限公司	宇通客车
冠城大通股份有限公司	冠城大通
中国葛洲坝集团股份有限公司	葛洲坝
河南银鸽实业投资股份有限公司	银鸽投资
浙江富润股份有限公司	浙江富润
凤凰光学股份有限公司	凤凰光学
中船江南重工股份有限公司	江南重工
上海梅林正广和股份有限公司	上海梅林
江苏中达新材料集团股份有限公司	中达股份
新疆天业股份有限公司	新疆天业
潍坊北大青鸟华光科技股份有限公司	青鸟华光
宋都基业投资股份有限公司	宋都股份
江苏澄星磷化工股份有限公司	澄星股份
人福医药集团股份公司	人福医药
金花企业(集团)股份有限公司	金花股份
东风电子科技股份有限公司	东风科技
天津海泰科技发展股份有限公司	海泰发展
广东博信投资控股股份有限公司	广东博信
中信国安葡萄酒业股份有限公司	中葡股份
北京同仁堂股份有限公司	同仁堂
东方金钰股份有限公司	东方金钰
中国长江航运集团南京油运股份有限公司	南京水运
中视传媒股份有限公司	中视传媒
特变电工股份有限公司	特变电工
新疆啤酒花股份有限公司	啤酒花
包头明天科技股份有限公司	明天科技
四川禾嘉股份有限公司	禾嘉股份
上海大名城企业股份有限公司	大名城
上海大名城企业股份有限公司	大名城
哈尔滨高科技(集团)股份有限公司	哈高科
云南云天化股份有限公司	云天化
上海开创国际海洋资源股份有限公司	开创国际
广州发展集团股份有限公司	广州发展
林海股份有限公司	林海股份
同方股份有限公司	同方股份
四川明星电力股份有限公司	明星电力
莱芜钢铁股份有限公司	莱钢股份
福建省青山纸业股份有限公司	青山纸业
上海汽车集团股份有限公司	上汽集团
江苏永鼎股份有限公司	永鼎股份
重庆路桥股份有限公司	重庆路桥
湖北美尔雅股份有限公司	美尔雅
甘肃亚盛实业(集团)股份有限公司	亚盛集团
国金证券股份有限公司	国金证券
中科英华高技术股份有限公司	中科英华
内蒙古包钢稀土(集团)高科技股份有限公司	包钢稀土
贵州长征天成控股股份有限公司	天成控股
浙江东日股份有限公司	浙江东日
东睦新材料集团股份有限公司	东睦股份
中国东方航空股份有限公司	东方航空
重庆三峡水利电力(集团)股份有限公司	三峡水利
西宁特殊钢股份有限公司	西宁特钢
中国东方红卫星股份有限公司	中国卫星
长发集团长江投资实业股份有限公司	长江投资
浙江东方集团股份有限公司	浙江东方
郑州煤电股份有限公司	郑州煤电
江苏宏图高科技股份有限公司	宏图高科
山西兰花科技创业股份有限公司	兰花科创
中铁铁龙集装箱物流股份有限公司	铁龙物流
杭州钢铁股份有限公司	杭钢股份
湖南金健米业股份有限公司	金健米业
江苏弘业股份有限公司	弘业股份
重庆太极实业(集团)股份有限公司	太极集团
宁波波导股份有限公司	波导股份
四川岷江水利电力股份有限公司	岷江水电
重庆啤酒股份有限公司	重庆啤酒
武汉东湖高新集团股份有限公司	东湖高新
乐凯胶片股份有限公司	乐凯胶片
武汉道博股份有限公司	道博股份
四川浪莎控股股份有限公司	浪莎股份
中青旅控股股份有限公司	中青旅
四川西部资源控股股份有限公司	西部资源
湖北兴发化工集团股份有限公司	兴发集团
贵州国创能源控股(集团)股份有限公司	国创能源
宁夏大元化工股份有限公司	大元股份
长春一东离合器股份有限公司	长春一东
廊坊发展股份有限公司	廊坊发展
中国船舶工业股份有限公司	中国船舶
上海航天汽车机电股份有限公司	航天机电
宁波维科精华集团股份有限公司	维科精华
厦门建发股份有限公司	建发股份
河北宝硕股份有限公司	宝硕股份
湖南华升股份有限公司	华升股份
永泰能源股份有限公司	永泰能源
中体产业集团股份有限公司	中体产业
北京市大龙伟业房地产开发股份有限公司	大龙地产
浙江巨化股份有限公司	巨化股份
北京天坛生物制品股份有限公司	天坛生物
深圳香江控股股份有限公司	香江控股
福建省南纸股份有限公司	福建南纸
宁夏新日恒力钢丝绳股份有限公司	新日恒力
北汽福田汽车股份有限公司	福田汽车
联美控股股份有限公司	联美控股
武汉三镇实业控股股份有限公司	武汉控股
太原重工股份有限公司	太原重工
上海建工集团股份有限公司	上海建工
上海贝岭股份有限公司	上海贝岭
河南黄河旋风股份有限公司	黄河旋风
卧龙地产集团股份有限公司	卧龙地产
美都控股股份有限公司	美都控股
中国玻纤股份有限公司	中国玻纤
雅戈尔集团股份有限公司	雅戈尔
哈尔滨东安汽车动力股份有限公司	东安动力
黑龙江黑化股份有限公司	黑化股份
瑞茂通供应链管理股份有限公司	瑞茂通
云大科技股份有限公司	云大科技
佳通轮胎股份有限公司	佳通轮胎
广东生益科技股份有限公司	生益科技
北方光电股份有限公司	光电股份
格力地产股份有限公司	格力地产
河南莲花味精股份有限公司	莲花味精
黑龙江国中水务股份有限公司	国中水务
兖州煤业股份有限公司	兖州煤业
吉林森林工业股份有限公司	吉林森工
锦州港股份有限公司	锦州港
锦州港股份有限公司	锦州港
包头华资实业股份有限公司	华资实业
兰州长城电工股份有限公司	长城电工
上海创兴资源开发股份有限公司	创兴资源
中牧实业股份有限公司	中牧股份
上海复星医药(集团)股份有限公司	复星医药
新疆伊力特实业股份有限公司	伊力特
大唐电信科技股份有限公司	大唐电信
安徽金种子酒业股份有限公司	金种子酒
江苏吴中实业股份有限公司	江苏吴中
内蒙古金宇集团股份有限公司	金宇集团
哈尔滨空调股份有限公司	哈空调
福建福日电子股份有限公司	福日电子
山东铝业股份有限公司	山东铝业
有研半导体材料股份有限公司	有研硅股
河南安彩高科股份有限公司	安彩高科
新湖中宝股份有限公司	新湖中宝
罗顿发展股份有限公司	罗顿发展
上海紫江企业集团股份有限公司	紫江企业
西藏诺迪康药业股份有限公司	西藏药业
山东江泉实业股份有限公司	江泉实业
扬州亚星客车股份有限公司	亚星客车
长春经开(集团)股份有限公司	长春经开
浙江医药股份有限公司	浙江医药
陕西秦岭水泥(集团)股份有限公司	秦岭水泥
安徽全柴动力股份有限公司	全柴动力
山东南山铝业股份有限公司	南山铝业
江苏阳光股份有限公司	江苏阳光
海南航空股份有限公司	海南航空
海南航空股份有限公司	海南航空
河南太龙药业股份有限公司	太龙药业
鲁商置业股份有限公司	鲁商置业
天津松江股份有限公司	天津松江
浙江升华拜克生物股份有限公司	升华拜克
贵州赤天化股份有限公司	赤天化
江西昌九生物化工股份有限公司	昌九生化
青岛碱业股份有限公司	青岛碱业
沧州大化股份有限公司	沧州大化
凌源钢铁股份有限公司	凌钢股份
浙江金鹰股份有限公司	金鹰股份
大连大杨创世股份有限公司	大杨创世
太原天龙集团股份有限公司	太原天龙集团
民丰特种纸股份有限公司	民丰特纸
广西桂冠电力股份有限公司	桂冠电力
安徽铜峰电子股份有限公司	铜峰电子
海南椰岛(集团)股份有限公司	海南椰岛
云南城投置业股份有限公司	云南城投
北京华业地产股份有限公司	华业地产
辽宁时代万恒股份有限公司	时代万恒
中昌海运股份有限公司	中昌海运
青海华鼎实业股份有限公司	青海华鼎
北京万通地产股份有限公司	万通地产
吉林成城集团股份有限公司	成城股份
陕西延长石油化建股份有限公司	延长化建
柳州两面针股份有限公司	两面针
南京纺织品进出口股份有限公司	南纺股份
新疆冠农果茸集团股份有限公司	冠农股份
广西梧州中恒集团股份有限公司	中恒集团
河南天方药业股份有限公司	天方药业
安徽鑫科新材料股份有限公司	鑫科材料
广汇能源股份有限公司	广汇能源
大湖水殖股份有限公司	大湖股份
北京首旅酒店(集团)股份有限公司	首旅酒店
广晟有色金属股份有限公司	广晟有色
湖北凯乐科技股份有限公司	凯乐科技
浙江阳光照明电器集团股份有限公司	阳光照明
内蒙古北方重型汽车股份有限公司	北方股份
路桥集团国际建设股份有限公司	路桥建设
云南景谷林业股份有限公司	景谷林业
北京城建投资发展股份有限公司	北京城建
浙江海正药业股份有限公司	海正药业
国电南京自动化股份有限公司	国电南自
江西赣粤高速公路股份有限公司	赣粤高速
中外运空运发展股份有限公司	外运发展
航天信息股份有限公司	航天信息
上海开开实业股份有限公司	开开实业
上海开开实业股份有限公司	开开实业
华芳纺织股份有限公司	华芳纺织
湖北武昌鱼股份有限公司	武昌鱼
江苏恒瑞医药股份有限公司	恒瑞医药
内蒙古亿利能源股份有限公司	亿利能源
东方国际创业股份有限公司	东方创业
重庆港九股份有限公司	重庆港九
南京中央商场(集团)股份有限公司	南京中商
太原化工股份有限公司	太化股份
南京钢铁股份有限公司	南钢股份
钱江水利开发股份有限公司	钱江水利
上海浦东路桥建设股份有限公司	浦东建设
河南羚锐制药股份有限公司	羚锐制药
江苏舜天股份有限公司	江苏舜天
大恒新纪元科技股份有限公司	大恒科技
亿阳信通股份有限公司	亿阳信通
华仪电气股份有限公司	华仪电气
内蒙古西水创业股份有限公司	西水股份
中电投远达环保(集团)股份有限公司	中电投远达
湖北三峡新型建材股份有限公司	三峡新材
内蒙古鄂尔多斯资源股份有限公司	鄂尔多斯
内蒙古鄂尔多斯资源股份有限公司	鄂尔多斯
兰州铝业股份有限公司	兰州铝业
美罗药业股份有限公司	美罗药业
安琪酵母股份有限公司	安琪酵母
蓝星化工新材料股份有限公司	蓝星新材
维维食品饮料股份有限公司	维维股份
南宁化工股份有限公司	南化股份
西安标准工业股份有限公司	标准股份
辽宁曙光汽车集团股份有限公司	曙光股份
江苏恒顺醋业股份有限公司	恒顺醋业
沈阳商业城股份有限公司	商业城
甘肃酒钢集团宏兴钢铁股份有限公司	酒钢宏兴
山东华泰纸业股份有限公司	华泰股份
万华化学集团股份有限公司	万华化学
广西桂东电力股份有限公司	桂东电力
甘肃荣华实业(集团)股份有限公司	荣华实业
河南平高电气股份有限公司	平高电气
中垦农业资源开发股份有限公司	中农资源
上海家化联合股份有限公司	上海家化
江西洪都航空工业股份有限公司	洪都航空
营口港务股份有限公司	营口港
安徽巢东水泥股份有限公司	巢东股份
潍坊亚星化学股份有限公司	亚星化学
上海振华重工(集团)股份有限公司	振华重工
上海振华重工(集团)股份有限公司	振华重工
四川国栋建设股份有限公司	国栋建设
天津市房地产发展(集团)股份有限公司	天房发展
瀚蓝环境股份有限公司	瀚蓝环境
珠海华发实业股份有限公司	华发股份
西藏天路股份有限公司	西藏天路
无锡商业大厦大东方股份有限公司	大厦股份
内蒙古兰太实业股份有限公司	兰太实业
天津中新药业集团股份有限公司	中新药业
天通控股股份有限公司	天通股份
四川宏达股份有限公司	宏达股份
广州白云山医药集团股份有限公司	NULL
长春燃气股份有限公司	长春燃气
国机汽车股份有限公司	国机汽车
澳柯玛股份有限公司	澳柯玛
美克国际家具股份有限公司	美克股份
西藏珠峰工业股份有限公司	西藏珠峰
新疆独山子天利高新技术股份有限公司	天利高新
华夏幸福基业股份有限公司	华夏幸福
陕西航天动力高科技股份有限公司	航天动力
武汉长江通信产业集团股份有限公司	长江通信
大连橡胶塑料机械股份有限公司	大橡塑
阳泉煤业(集团)股份有限公司	阳泉煤业
山东高速股份有限公司	山东高速
亚宝药业集团股份有限公司	亚宝药业
浙江龙盛集团股份有限公司	浙江龙盛
成都旭光电子股份有限公司	旭光股份
甘肃省敦煌种业股份有限公司	敦煌种业
精伦电子股份有限公司	精伦电子
牡丹江恒丰纸业股份有限公司	恒丰纸业
承德新新钒钛股份有限公司	承德钒钛
国旅联合股份有限公司	国旅联合
新疆塔里木农业综合开发股份有限公司	新农开发
吉林华微电子股份有限公司	华微电子
北京华联综合超市股份有限公司	华联综超
江西铜业股份有限公司	江西铜业
江西联创光电科技股份有限公司	联创光电
通化葡萄酒股份有限公司	通葡股份
宁波韵升股份有限公司	宁波韵升
贵州红星发展股份有限公司	红星发展
广西五洲交通股份有限公司	五洲交通
西南证券股份有限公司	西南证券
江苏三房巷实业股份有限公司	三房巷
万向德农股份有限公司	万向德农
中航机载电子股份有限公司	中航电子
中文天地出版传媒股份有限公司	中文传媒
华菱星马汽车(集团)股份有限公司	华菱星马
北京首都开发股份有限公司	首开股份
江苏宁沪高速公路股份有限公司	宁沪高速
四川天一科技股份有限公司	天科股份
陕西宝光真空电器股份有限公司	宝光股份
健康元药业集团股份有限公司	健康元
青海贤成矿业股份有限公司	贤成矿业
广东明珠集团股份有限公司	广东明珠
金地(集团)股份有限公司	金地集团
山东金泰集团股份有限公司	金泰集团
北京巴士传媒股份有限公司	北巴传媒
浙江海越股份有限公司	海越股份
福建龙净环保股份有限公司	龙净环保
南通江山农药化工股份有限公司	江山股份
金瑞新材料科技股份有限公司	金瑞科技
四川成发航空科技股份有限公司	成发科技
盛和资源控股股份有限公司	盛和资源
广州东华实业股份有限公司	东华实业
贵州盘江精煤股份有限公司	盘江股份
沈阳金山能源股份有限公司	金山股份
安源煤业集团股份有限公司	安源煤业
凯诺科技股份有限公司	凯诺科技
抚顺特殊钢股份有限公司	抚顺特钢
江苏红豆实业股份有限公司	红豆股份
海润光伏科技股份有限公司	海润光伏
河南大有能源股份有限公司	大有能源
北京动力源科技股份有限公司	动力源
国电南瑞科技股份有限公司	国电南瑞
山西安泰集团股份有限公司	安泰集团
唐山三友化工股份有限公司	三友化工
北京华胜天成科技股份有限公司	华胜天成
浙江中国小商品城集团股份有限公司	小商品城
湘潭电机股份有限公司	湘电股份
安徽江淮汽车股份有限公司	江淮汽车
新疆天润乳业股份有限公司	新疆天润
上海现代制药股份有限公司	现代制药
武汉国药科技股份有限公司	国药科技
昆明制药集团股份有限公司	昆明制药
柳州化工股份有限公司	柳化股份
新疆青松建材化工(集团)股份有限公司	青松建化
山东华鲁恒升化工股份有限公司	华鲁恒升
中远航运股份有限公司	中远航运
北京三元食品股份有限公司	三元股份
吉林吉恩镍业股份有限公司	吉恩镍业
广东冠豪高新技术股份有限公司	冠豪高新
北方导航控制技术股份有限公司	北方导航
漳州片仔癀药业股份有限公司	片仔癀
通威股份有限公司	通威股份
河南瑞贝卡发制品股份有限公司	瑞贝卡
安徽国通高新管业股份有限公司	国通管业
深圳市金证科技股份有限公司	金证股份
华纺股份有限公司	华纺股份
宁夏建材集团股份有限公司	宁夏建材
重庆涪陵电力实业股份有限公司	涪陵电力
西安交大博通资讯股份有限公司	交大博通
宝鸡钛业股份有限公司	宝钛股份
株洲时代新材料科技股份有限公司	时代新材
贵研铂业股份有限公司	贵研铂业
杭州士兰微电子股份有限公司	士兰微
江西洪城水业股份有限公司	洪城水业
延边石岘白麓纸业股份有限公司	石岘纸业
北京空港科技园区股份有限公司	空港股份
四川迪康科技药业股份有限公司	迪康药业
山东好当家海洋发展股份有限公司	好当家
天津百利特精电气股份有限公司	百利电气
风神轮胎股份有限公司	风神股份
安徽六国化工股份有限公司	六国化工
无锡华光锅炉股份有限公司	华光股份
湖南湘邮科技股份有限公司	湘邮科技
浙江杭萧钢构股份有限公司	杭萧钢构
湖南科力远新能源股份有限公司	科力远
株洲千金药业股份有限公司	千金药业
凌云工业股份有限公司	凌云股份
双良节能系统股份有限公司	双良节能
福建南纺股份有限公司	福建南纺
北京中创信测科技股份有限公司	中创信测
江苏扬农化工股份有限公司	扬农化工
江苏亨通光电股份有限公司	亨通光电
天津天药药业股份有限公司	天药股份
中金黄金股份有限公司	中金黄金
鹏欣环球资源股份有限公司	鹏欣资源
龙元建设集团股份有限公司	龙元建设
福建凤竹纺织科技股份有限公司	凤竹纺织
晋西车轴股份有限公司	晋西车轴
长江精工钢结构(集团)股份有限公司	精工钢构
云南驰宏锌锗股份有限公司	驰宏锌锗
烽火通信科技股份有限公司	烽火通信
广东科达机电股份有限公司	科达机电
中化国际(控股)股份有限公司	中化国际
航天晨光股份有限公司	航天晨光
安徽水利开发股份有限公司	安徽水利
华丽家族股份有限公司	华丽家族
四川西昌电力股份有限公司	西昌电力
新疆库尔勒香梨股份有限公司	香梨股份
方大特钢科技股份有限公司	方大特钢
上海大屯能源股份有限公司	上海能源
新疆天富热电股份有限公司	天富热电
黑牡丹(集团)股份有限公司	黑牡丹
国药集团药业股份有限公司	国药股份
腾达建设集团股份有限公司	腾达建设
江苏联环药业股份有限公司	联环药业
海南海岛建设股份有限公司	海岛建设
方大炭素新材料科技股份有限公司	方大炭素
上海置信电气股份有限公司	置信电气
康美药业股份有限公司	康美药业
贵州茅台酒股份有限公司	贵州茅台
铜陵中发三佳科技股份有限公司	中发科技
浙江华海药业股份有限公司	华海药业
江苏中天科技股份有限公司	中天科技
贵州贵航汽车零部件股份有限公司	贵航股份
长园集团股份有限公司	长园集团
浙江菲达环保科技股份有限公司	菲达环保
江苏江南高纤股份有限公司	江南高纤
中铁二局股份有限公司	中铁二局
山东省药用玻璃股份有限公司	山东药玻
上海交大昂立股份有限公司	交大昂立
河南豫光金铅股份有限公司	豫光金铅
山东宏达矿业股份有限公司	宏达矿业
南京栖霞建设股份有限公司	栖霞建设
天士力制药集团股份有限公司	天士力
中国软件与技术服务股份有限公司	中国软件
亿晶光电科技股份有限公司	亿晶光电
北海国发海洋生物产业股份有限公司	北海国发
太原狮头水泥股份有限公司	狮头股份
新疆赛里木现代农业股份有限公司	新赛股份
甘肃莫高实业发展股份有限公司	莫高股份
新疆城建(集团)股份有限公司	新疆城建
山煤国际能源集团股份有限公司	山煤国际
山东黄金矿业股份有限公司	山东黄金
深圳高速公路股份有限公司	深高速
厦门钨业股份有限公司	厦门钨业
保定天威保变电气股份有限公司	天威保变
时代出版传媒股份有限公司	时代出版
安徽方兴科技股份有限公司	方兴科技
河北太行水泥股份有限公司	太行水泥
上海九龙山旅游股份有限公司	九龙山
上海九龙山旅游股份有限公司	九龙山
广西北生药业股份有限公司	北生药业
江苏康缘药业股份有限公司	康缘药业
四川大西洋焊接材料股份有限公司	大西洋
河北衡水老白干酒业股份有限公司	老白干酒
北京金自天正智能控制股份有限公司	金自天正
江西长运股份有限公司	江西长运
国睿科技股份有限公司	国睿科技
厦门法拉电子股份有限公司	法拉电子
重庆市迪马实业股份有限公司	迪马股份
湖北洪城通用机械股份有限公司	洪城股份
安徽山鹰纸业股份有限公司	山鹰纸业
中珠控股股份有限公司	中珠控股
安阳钢铁股份有限公司	安阳钢铁
恒生电子股份有限公司	恒生电子
信雅达系统工程股份有限公司	信雅达
浙江康恩贝制药股份有限公司	康恩贝
福建省燕京惠泉啤酒股份有限公司	惠泉啤酒
芜湖港储运股份有限公司	芜湖港
浙江万好万家实业股份有限公司	万好万家
铜陵精达特种电磁线股份有限公司	精达股份
北京京能电力股份有限公司	京能电力
青岛黄海橡胶股份有限公司	黄海股份
卧龙电气集团股份有限公司	卧龙电气
新疆八一钢铁股份有限公司	八一钢铁
天地科技股份有限公司	天地科技
海洋石油工程股份有限公司	海油工程
江苏长电科技股份有限公司	长电科技
安徽海螺水泥股份有限公司	海螺水泥
山东金晶科技股份有限公司	金晶科技
山东新华医疗器械股份有限公司	新华医疗
用友软件股份有限公司	用友软件
广东榕泰实业股份有限公司	广东榕泰
泰豪科技股份有限公司	泰豪科技
上海航空股份有限公司	上海航空
福建龙溪轴承(集团)股份有限公司	龙溪股份
大连圣亚旅游控股股份有限公司	大连圣亚
贵州益佰制药股份有限公司	益佰制药
河南中孚实业股份有限公司	中孚实业
浙江新安化工集团股份有限公司	新安股份
光明乳业股份有限公司	光明乳业
黑龙江北大荒农业股份有限公司	北大荒
熊猫烟花集团股份有限公司	熊猫烟花
青岛啤酒股份有限公司	青岛啤酒
方正科技集团股份有限公司	方正科技
上海仪电电子股份有限公司	仪电电子
上海仪电电子股份有限公司	仪电电子
厦门大洲兴业能源控股股份有限公司	兴业控股
上海市北高新股份有限公司	市北高新
上海市北高新股份有限公司	市北高新
上海汇通能源股份有限公司	汇通能源
上海金丰投资股份有限公司	金丰投资
上海实业医药投资股份有限公司	上实医药
上海宽频科技股份有限公司	上海科技
金杯汽车股份有限公司	金杯汽车
中国纺织机械股份有限公司	中国纺机
中国纺织机械股份有限公司	中国纺机
大众交通(集团)股份有限公司	大众交通
大众交通(集团)股份有限公司	大众交通
老凤祥股份有限公司	老凤祥
老凤祥股份有限公司	老凤祥
上海神奇制药投资管理股份有限公司	神奇制药
上海神奇制药投资管理股份有限公司	神奇制药
上海鼎立科技发展(集团)股份有限公司	鼎立股份
上海鼎立科技发展(集团)股份有限公司	鼎立股份
上海丰华(集团)股份有限公司	丰华股份
上海金枫酒业股份有限公司	金枫酒业
上海联华合纤股份有限公司	联华合纤
上海联华合纤股份有限公司	联华合纤
上海氯碱化工股份有限公司	氯碱化工
上海氯碱化工股份有限公司	氯碱化工
上海海立(集团)股份有限公司	海立股份
上海海立(集团)股份有限公司	海立股份
上海市天宸股份有限公司	天宸股份
上海华鑫股份有限公司	华鑫股份
上海嘉宝实业(集团)股份有限公司	嘉宝集团
双钱集团股份有限公司	双钱股份
双钱集团股份有限公司	双钱股份
上海复旦复华科技股份有限公司	复旦复华
上海申达股份有限公司	申达股份
上海输配电股份有限公司	上电股份
上海新世界股份有限公司	新世界
上海棱光实业股份有限公司	棱光实业
上海龙头(集团)股份有限公司	龙头股份
上海百联集团股份有限公司	百联股份
上海华联商厦股份有限公司	华联商厦
浙报传媒集团股份有限公司	浙报传媒
上海澄海企业发展股份有限公司	澄海股份
上海大众公用事业(集团)股份有限公司	大众公用
上海三爱富新材料股份有限公司	三爱富
百视通新媒体股份有限公司	百视通
上海新黄浦置业股份有限公司	新黄浦
上海金桥出口加工区开发股份有限公司	浦东金桥
上海金桥出口加工区开发股份有限公司	浦东金桥
号百控股股份有限公司	号百控股
上海万业企业股份有限公司	万业企业
申能股份有限公司	Ｇ申能
上海爱建股份有限公司	爱建股份
乐山电力股份有限公司	乐山电力
中源协和干细胞生物工程股份公司	中源协和
上海同达创业投资股份有限公司	同达创业
上海外高桥保税区开发股份有限公司	外高桥
上海外高桥保税区开发股份有限公司	外高桥
上海城投控股股份有限公司	城投控股
上海锦江国际实业投资股份有限公司	锦江投资
上海锦江国际实业投资股份有限公司	锦江投资
上海飞乐音响股份有限公司	飞乐音响
上海爱使股份有限公司	爱使股份
上海申华控股股份有限公司	申华控股
上海飞乐股份有限公司	飞乐股份
上海豫园旅游商城股份有限公司	豫园商城
珠海市博元投资股份有限公司	博元投资
信达地产股份有限公司	信达地产
北京电子城投资开发股份有限公司	电子城
福耀玻璃工业集团股份有限公司	福耀玻璃
上海新南洋股份有限公司	新南洋
上海强生控股股份有限公司	强生控股
上海陆家嘴金融贸易区开发股份有限公司	陆家嘴
上海陆家嘴金融贸易区开发股份有限公司	陆家嘴
哈药集团股份有限公司	哈药股份
天地源股份有限公司	天地源
西南药业股份有限公司	西南药业
无锡市太极实业股份有限公司	太极实业
浙江尖峰集团股份有限公司	尖峰集团
杭州天目山药业股份有限公司	天目药业
广东东阳光铝业股份有限公司	东阳光铝
四川川投能源股份有限公司	川投能源
中华企业股份有限公司	中华企业
上海交运集团股份有限公司	交运股份
航天通信控股集团股份有限公司	航天通信
四川金顶(集团)股份有限公司	四川金顶
金山开发建设股份有限公司	金山开发
金山开发建设股份有限公司	金山开发
上海普天邮通科技股份有限公司	普天邮通
上海普天邮通科技股份有限公司	普天邮通
万鸿集团股份有限公司	万鸿集团
南京新街口百货商店股份有限公司	南京新百
京投银泰股份有限公司	京投银泰
广州珠江实业开发股份有限公司	珠江实业
广州广船国际股份有限公司	广船国际
厦门金龙汽车集团股份有限公司	金龙汽车
甘肃刚泰控股(集团)股份有限公司	刚泰控股
中国石化上海石油化工股份有限公司	上海石化
上海三毛企业(集团)股份有限公司	上海三毛
上海三毛企业(集团)股份有限公司	上海三毛
青岛海尔股份有限公司	青岛海尔
阳煤化工股份有限公司	阳煤化工
上海亚通股份有限公司	亚通股份
福建东百集团股份有限公司	东百集团
大商股份有限公司	大商股份
上海大江食品集团股份有限公司	大江股份
上海大江食品集团股份有限公司	大江股份
上海多伦实业股份有限公司	多伦股份
长春欧亚集团股份有限公司	欧亚集团
济南轻骑摩托车股份有限公司	济南轻骑
济南轻骑摩托车股份有限公司	济南轻骑
辽源均胜电子股份有限公司	均胜电子
哈尔滨工大高新技术产业开发股份有限公司	工大高新
四川沱牌舍得酒业股份有限公司	沱牌舍得
三安光电股份有限公司	三安光电
浙江物产中大元通集团股份有限公司	物产中大
中航投资控股股份有限公司	中航投资
西安曲江文化旅游股份有限公司	曲江文旅
彩虹显示器件股份有限公司	彩虹股份
上海海博股份有限公司	海博股份
常林股份有限公司	常林股份
盛屯矿业集团股份有限公司	盛屯矿业
南宁百货大楼股份有限公司	南宁百货
南京医药股份有限公司	南京医药
青海金瑞矿业发展股份有限公司	金瑞矿业
松辽汽车股份有限公司	松辽汽车
江苏凤凰置业投资股份有限公司	凤凰股份
天津港股份有限公司	天津港
东软集团股份有限公司	东软股份
大连热电股份有限公司	大连热电
甘肃祁连山水泥集团股份有限公司	祁连山
新疆百花村股份有限公司	百花村
河北金牛化工股份有限公司	金牛化工
北京首商集团股份有限公司	首商股份
宁波富达股份有限公司	宁波富达
云南云维股份有限公司	云维股份
华电能源股份有限公司	华电能源
华电能源股份有限公司	华电能源
山东鲁北化工股份有限公司	鲁北化工
佳都新太科技股份有限公司	佳都新太
重庆百货大楼股份有限公司	重庆百货
中国高科集团股份有限公司	中国高科
湖南海利化工股份有限公司	湖南海利
上海新梅置业股份有限公司	上海新梅
成都前锋电子股份有限公司	前锋股份
福建实达集团股份有限公司	实达集团
山东新华锦国际股份有限公司	新华锦
苏州新区高新技术产业股份有限公司	苏州高新
中粮屯河股份有限公司	中粮屯河
兰州民百(集团)股份有限公司	兰州民百
辽宁成大股份有限公司	辽宁成大
山西焦化股份有限公司	山西焦化
华域汽车系统股份有限公司	华域汽车
长春一汽富维汽车零部件股份有限公司	一汽富维
华远地产股份有限公司	华远地产
大唐华银电力股份有限公司	华银电力
中茵股份有限公司	中茵股份
江苏索普化工股份有限公司	江苏索普
大连大显控股股份有限公司	大显股份
上海实业发展股份有限公司	上实发展
西藏旅游股份有限公司	西藏旅游
江中药业股份有限公司	江中药业
天津市海运股份有限公司	天津海运
天津市海运股份有限公司	天津海运
河南东方银星投资股份有限公司	东方银星
上海锦江国际酒店发展股份有限公司	锦江股份
上海锦江国际酒店发展股份有限公司	锦江股份
厦门国贸集团股份有限公司	厦门国贸
浪潮软件股份有限公司	浪潮软件
长江出版传媒股份有限公司	长江传媒
辽宁红阳能源投资股份有限公司	红阳能源
海南正和实业集团股份有限公司	正和股份
中航黑豹股份有限公司	中航黑豹
安徽合力股份有限公司	安徽合力
通策医疗投资股份有限公司	通策医疗
中电广通股份有限公司	中电广通
中航重机股份有限公司	中航重机
烟台园城黄金股份有限公司	园城黄金
运盛(上海)实业股份有限公司	运盛实业
宁波富邦精业集团股份有限公司	宁波富邦
武汉祥龙电业股份有限公司	祥龙电业
江苏综艺股份有限公司	综艺股份
广誉远中药股份有限公司	广誉远
西藏城市发展投资股份有限公司	西藏城投
武汉市汉商集团股份有限公司	汉商集团
南京熊猫电子股份有限公司	南京熊猫
东方通信股份有限公司	东方通信
东方通信股份有限公司	东方通信
烟台新潮实业股份有限公司	新潮实业
新疆友好(集团)股份有限公司	友好集团
四川水井坊股份有限公司	水井坊
山西通宝能源股份有限公司	通宝能源
上海辅仁实业(集团)股份有限公司	上海辅仁
新余钢铁股份有限公司	新钢股份
鲁信创业投资集团股份有限公司	鲁信创投
鲁银投资集团股份有限公司	鲁银投资
银川新华百货商业集团股份有限公司	新华百货
东方电气集团东方锅炉股份有限公司	东方锅炉
中储发展股份有限公司	中储股份
山东鲁抗医药股份有限公司	鲁抗医药
浙江中国轻纺城集团股份有限公司	轻纺城
京能置业股份有限公司	京能置业
云南煤业能源股份有限公司	云煤能源
宜宾纸业股份有限公司	宜宾纸业
张家港保税科技股份有限公司	保税科技
国电电力发展股份有限公司	国电电力
浙江钱江生物化学股份有限公司	钱江生化
浙大网新科技股份有限公司	浙大网新
宁波海运股份有限公司	宁波海运
天津环球磁卡股份有限公司	天津磁卡
华新水泥股份有限公司	华新水泥
华新水泥股份有限公司	华新水泥
福建水泥股份有限公司	福建水泥
河北威远生物化工股份有限公司	威远生化
鹏博士电信传媒集团股份有限公司	鹏博士
江苏悦达投资股份有限公司	悦达投资
沈机集团昆明机床股份有限公司	昆明机床
山东天业恒基股份有限公司	天业股份
马鞍山钢铁股份有限公司	马钢股份
山西杏花村汾酒厂股份有限公司	山西汾酒
神马实业股份有限公司	神马股份
东方集团股份有限公司	东方集团
华北制药股份有限公司	华北制药
杭州解百集团股份有限公司	杭州解百
厦门厦工机械股份有限公司	厦工股份
安信信托投资股份有限公司	安信信托
西安宏盛科技发展股份有限公司	宏盛科技
中路股份有限公司	中路股份
中路股份有限公司	中路股份
上海耀皮玻璃集团股份有限公司	耀皮玻璃
上海耀皮玻璃集团股份有限公司	耀皮玻璃
上海隧道工程股份有限公司	隧道股份
天津劝业场(集团)股份有限公司	津劝业
上海物资贸易股份有限公司	上海物贸
上海物资贸易股份有限公司	上海物贸
上海世茂股份有限公司	世茂股份
上海益民商业集团股份有限公司	益民集团
上海新华传媒股份有限公司	新华传媒
上海兰生股份有限公司	兰生股份
上海友谊集团股份有限公司	友谊股份
上海友谊集团股份有限公司	友谊股份
成商集团股份有限公司	成商集团
哈药集团三精制药股份有限公司	三精制药
香溢融通控股集团股份有限公司	香溢融通
陕西广电网络传媒(集团)股份有限公司	广电网络
上海东方明珠(集团)股份有限公司	东方明珠
上海第一医药股份有限公司	第一医药
上海申通地铁股份有限公司	申通地铁
上海机电股份有限公司	上海机电
上海机电股份有限公司	上海机电
上海界龙实业集团股份有限公司	界龙实业
海通证券股份有限公司	海通证券
上海九百股份有限公司	上海九百
四川长虹电器股份有限公司	四川长虹
浙江新湖创业投资股份有限公司	新湖创业
上海柴油机股份有限公司	上柴股份
上海柴油机股份有限公司	上柴股份
上海中西药业股份有限公司	中西药业
上工申贝(集团)股份有限公司	上工申贝
上工申贝(集团)股份有限公司	上工申贝
丹化化工科技股份有限公司	丹化科技
丹化化工科技股份有限公司	丹化科技
上海宝信软件股份有限公司	宝信软件
上海宝信软件股份有限公司	宝信软件
上海同济科技实业股份有限公司	同济科技
重庆万里新能源股份有限公司	万里股份
上海自动化仪表股份有限公司	自仪股份
上海自动化仪表股份有限公司	自仪股份
上海医药集团股份有限公司	上海医药
上海华东电脑股份有限公司	华东电脑
上海海欣集团股份有限公司	海欣股份
上海海欣集团股份有限公司	海欣股份
龙建路桥股份有限公司	龙建股份
江苏春兰制冷设备股份有限公司	春兰股份
北京航天长峰股份有限公司	航天长峰
长春百货大楼集团股份有限公司	长百集团
哈工大首创科技股份有限公司	工大首创
银座集团股份有限公司	银座股份
北京王府井百货(集团)股份有限公司	王府井
北人印刷机械股份有限公司	北人股份
北京城乡贸易中心股份有限公司	北京城乡
南通科技投资集团股份有限公司	南通科技
内蒙古蒙电华能热电股份有限公司	内蒙华电
哈尔滨哈投投资股份有限公司	哈投股份
百大集团股份有限公司	百大集团
广东肇庆星湖生物科技股份有限公司	星湖科技
通化东宝药业股份有限公司	通化东宝
广东梅雁吉祥水电股份有限公司	梅雁吉祥
远东电缆股份有限公司	远东电缆
厦门华侨电子股份有限公司	厦华电子
中国石化仪征化纤股份有限公司	仪征化纤
中炬高新技术实业(集团)股份有限公司	中炬高新
梅花生物科技集团股份有限公司	梅花集团
天津创业环保集团股份有限公司	创业环保
东方电气股份有限公司	东方电气
洛阳玻璃股份有限公司	洛阳玻璃
中国嘉陵工业股份有限公司(集团)	中国嘉陵
航天时代电子技术股份有限公司	航天电子
成都博瑞传播股份有限公司	博瑞传播
吉林亚泰(集团)股份有限公司	亚泰集团
山东华联矿业控股股份有限公司	华联矿业
云南博闻科技实业股份有限公司	博闻科技
宁波杉杉股份有限公司	杉杉股份
宏发科技股份有限公司	宏发科技
国投电力控股股份有限公司	国投电力
内蒙古伊利实业集团股份有限公司	伊利股份
新疆众和股份有限公司	新疆众和
南京化纤股份有限公司	南京化纤
中房置业股份有限公司	中房股份
哈尔滨秋林集团股份有限公司	秋林集团
宝诚投资股份有限公司	宝诚投资
西安航空动力股份有限公司	航空动力
广州广日股份有限公司	广日股份
上海张江高科技园区开发股份有限公司	张江高科
中海(海南)海盛船务股份有限公司	中海海盛
厦门国际航空港股份有限公司	厦门空港
三联商社股份有限公司	三联商社
中国长江电力股份有限公司	长江电力
山东滨州渤海活塞股份有限公司	渤海活塞
岳阳林纸股份有限公司	岳阳林纸
山东博汇纸业股份有限公司	博汇纸业
包头北方创业股份有限公司	北方创业
湖南郴电国际发展股份有限公司	郴电国际
湖南新五丰股份有限公司	新五丰
武汉健民药业集团股份有限公司	武汉健民
北矿磁材科技股份有限公司	北矿磁材
安徽雷鸣科化股份有限公司	雷鸣科化
科达集团股份有限公司	科达股份
赤峰吉隆黄金矿业股份有限公司	吉隆黄金
安徽四创电子股份有限公司	四创电子
广汽长丰汽车股份有限公司	广汽长丰
贵州钢绳股份有限公司	贵绳股份
马应龙药业集团股份有限公司	马应龙
云南文山电力股份有限公司	文山电力
开滦能源化工股份有限公司	开滦股份
上海锦江国际旅游股份有限公司	锦旅Ｂ股
上海阳晨投资股份有限公司	阳晨Ｂ股
上海汇丽建材股份有限公司	汇丽Ｂ股
内蒙古伊泰煤炭股份有限公司	伊泰Ｂ股
浙江东南发电股份有限公司	东电Ｂ股
江苏新城地产股份有限公司	新城Ｂ股
大化集团大连化工股份有限公司	大化Ｂ股
恒天凯马股份有限公司	凯马股份
黄石东贝电器股份有限公司	东贝Ｂ股
上海凌云实业发展股份有限公司	凌云Ｂ股
东信和平科技股份有限公司	东信和平
鸿达兴业股份有限公司	鸿达兴业
浙江伟星实业发展股份有限公司	伟星股份
华邦颖泰股份有限公司	华邦颖泰
广东德豪润达电气股份有限公司	德豪润达
浙江精功科技股份有限公司	精功科技
华兰生物工程股份有限公司	华兰生物
深圳市大族激光科技股份有限公司	大族激光
天奇自动化工程股份有限公司	天奇股份
浙江传化股份有限公司	传化股份
浙江盾安人工环境股份有限公司	盾安环境
浙江凯恩特种材料股份有限公司	凯恩股份
湖北中航精机科技股份有限公司	中航精机
黄山永新股份有限公司	永新股份
江苏霞客环保色纺股份有限公司	霞客环保
广东世荣兆业股份有限公司	世荣兆业
安徽华星化工股份有限公司	华星化工
浙江杭州鑫富药业股份有限公司	Ｇ鑫富
浙江京新药业股份有限公司	京新药业
中捷缝纫机股份有限公司	中捷股份
上海科华生物工程股份有限公司	科华生物
四川海特高新技术股份有限公司	海特高新
苏宁云商集团股份有限公司	苏宁云商
贵州航天电器股份有限公司	航天电器
山东威达机械股份有限公司	山东威达
七喜控股股份有限公司	七喜控股
思源电气股份有限公司	思源电气
福建七匹狼实业股份有限公司	七匹狼
中山大学达安基因股份有限公司	达安基因
巨轮股份有限公司	巨轮股份
浙江苏泊尔股份有限公司	苏泊尔
丽江玉龙旅游股份有限公司	丽江旅游
浙江美欣达印染集团股份有限公司	美欣达
中山华帝燃具股份有限公司	华帝股份
宁波宜科科技实业股份有限公司	宜科科技
贵州久联民爆器材发展股份有限公司	久联发展
北京双鹭药业股份有限公司	双鹭药业
山东钢铁股份有限公司	山东钢铁
金发科技股份有限公司	金发科技
风帆股份有限公司	风帆股份
株洲冶炼集团股份有限公司	株冶集团
国投中鲁果汁股份有限公司	国投中鲁
河北福成五丰食品股份有限公司	福成五丰
安徽恒源煤电股份有限公司	恒源煤电
宝胜科技创新股份有限公司	宝胜股份
广东省宜华木业股份有限公司	宜华木业
四川广安爱众股份有限公司	广安爱众
江苏汇鸿股份有限公司	汇鸿股份
宁波热电股份有限公司	宁波热电
合肥荣事达三洋电器股份有限公司	合肥三洋
陕西建设机械股份有限公司	建设机械
浙江航民股份有限公司	航民股份
华电国际电力股份有限公司	华电国际
贵州黔源电力股份有限公司	黔源电力
南京港股份有限公司	南京港
中国中材国际工程股份有限公司	中材国际
山东登海种业股份有限公司	登海种业
华孚色纺股份有限公司	华孚色纺
德华兔宝宝装饰新材股份有限公司	兔宝宝
包头铝业股份有限公司	包头铝业
江苏三友集团股份有限公司	江苏三友
国光电器股份有限公司	国光电器
洛阳轴研科技股份有限公司	轴研科技
深圳成霖洁具股份有限公司	成霖股份
宁波华翔电子股份有限公司	宁波华翔
同方国芯电子股份有限公司	同方国芯
浙江三花股份有限公司	三花股份
北京世纪瑞尔技术股份有限公司	世纪瑞尔
中工国际工程股份有限公司	中工国际
深圳市同洲电子股份有限公司	深圳同洲
云南盐化股份有限公司	云南盐化
大同煤业股份有限公司	大同煤业
中国银行股份有限公司	中国银行
广东德美精细化工股份有限公司	德美化工
深圳市得润电子股份有限公司	得润电子
横店集团东磁股份有限公司	横店东磁
保利房地产(集团)股份有限公司	保利房地产
中钢集团安徽天源科技股份有限公司	天源科技
上海威尔泰工业自动化股份有限公司	威尔泰
云南旅游股份有限公司	云南旅游
大秦铁路股份有限公司	大秦铁路
广东水电二局股份有限公司	粤水电
浙江江山化工股份有限公司	江山化工
宏润建设集团股份有限公司	宏润建设
远光软件股份有限公司	远光软件
浙江华峰氨纶股份有限公司	华峰氨纶
东华软件股份公司	东华软件
瑞泰科技股份有限公司	瑞泰科技
中国国际航空股份有限公司	中国国航
浙江景兴纸业股份有限公司	景兴纸业
江西黑猫炭黑股份有限公司	黑猫股份
北京北陆药业股份有限公司	北陆药业
北京华宇软件股份有限公司	华宇软件
山西潞安环保能源开发股份有限公司	潞安环能
獐子岛集团股份有限公司	獐子岛
北京久其软件股份有限公司	久其软件
福建众和股份有限公司	众和股份
江苏宏宝五金股份有限公司	江苏宏宝
山东德棉股份有限公司	德棉股份
北京北辰实业股份有限公司	北辰实业
软控股份有限公司	软控股份
日照港股份有限公司	日照港
江苏东源电器集团股份有限公司	东源电器
江苏沙钢股份有限公司	沙钢股份
广东雪莱特光电科技股份有限公司	雪莱特
中国工商银行股份有限公司	工商银行
苏州固锝电子股份有限公司	苏州固锝
山东太阳纸业股份有限公司	太阳纸业
江苏大港股份有限公司	大港股份
上海国际港务(集团)股份有限公司	上港集团
中材科技股份有限公司	中材科技
苏州金螳螂建筑装饰股份有限公司	金螳螂
浙江栋梁新材股份有限公司	栋梁新材
平顶山天安煤业股份有限公司	平煤股份
孚日集团股份有限公司	孚日股份
广州海鸥卫浴用品股份有限公司	海鸥卫浴
浙江万丰奥威汽轮股份有限公司	万丰奥威
山东东方海洋科技股份有限公司	东方海洋
河南新野纺织股份有限公司	新野纺织
山东鲁阳股份有限公司	鲁阳股份
苏州新海宜通信科技股份有限公司	新海宜
招商局能源运输股份有限公司	招商轮船
江苏金智科技股份有限公司	金智科技
江苏国泰国际集团国贸股份有限公司	江苏国泰
新疆中泰化学股份有限公司	化学股份
大唐国际发电股份有限公司	大唐发电
浙江网盛生意宝股份有限公司	生意宝
青岛金王应用化学股份有限公司	青岛金王
国脉科技股份有限公司	国脉科技
福建冠福现代家用股份有限公司	冠福家用
广东鸿图科技股份有限公司	广东鸿图
浙江海翔药业股份有限公司	海翔药业
新疆天康畜牧生物技术股份有限公司	天康生物
山河智能装备股份有限公司	山河智能
湖南南岭民用爆破器材股份有限公司	南岭民爆
福建浔兴拉链科技股份有限公司	浔兴股份
广博集团股份有限公司	广博股份
深圳信隆实业股份有限公司	信隆实业
广深铁路股份有限公司	广深铁路
恒宝股份有限公司	恒宝股份
福建三钢闽光股份有限公司	三钢闽光
沧州明珠塑料股份有限公司	沧州明珠
深圳莱宝高科技股份有限公司	莱宝高科
陕西兴化化学股份有限公司	兴化股份
晋亿实业股份有限公司	晋亿实业
中国人寿保险股份有限公司	中国人寿
山东沃华医药科技股份有限公司	沃华医药
威海广泰空港设备股份有限公司	威海广泰
深圳市科陆电子科技股份有限公司	科陆电子
三变科技股份有限公司	三变科技
云南罗平锌电股份有限公司	罗平锌电
三维通信股份有限公司	三维通信
宁波新海电气股份有限公司	新海股份
湖南天润实业控股股份有限公司	天润控股
中国海诚工程科技股份有限公司	中国海诚
东港股份有限公司	东港股份
兴业银行股份有限公司	兴业银行
吉林紫鑫药业股份有限公司	紫鑫药业
宁波康强电子股份有限公司	康强电子
柳州钢铁股份有限公司	柳钢股份
宁波天邦股份有限公司	天邦股份
重庆钢铁股份有限公司	重庆钢铁
中国平安保险(集团)股份有限公司	中国平安
荣信电力电子股份有限公司	荣信股份
金陵饭店股份有限公司	金陵饭店
湘潭电化科技股份有限公司	湘潭电化
北京博晖创新光电技术股份有限公司	博晖创新
天马轴承集团股份有限公司	天马股份
浙江银轮机械股份有限公司	银轮股份
江苏连云港港口股份有限公司	连云港
深圳市沃尔核材股份有限公司	沃尔核材
天津中环半导体股份有限公司	中环股份
江苏新民纺织科技股份有限公司	新民科技
利欧集团股份有限公司	利欧股份
河南恒星科技股份有限公司	恒星科技
天津普林电路股份有限公司	天津普林
浙江东南网架股份有限公司	东南网架
安徽安纳达钛业股份有限公司	安纳达
广宇集团股份有限公司	广宇集团
潍柴动力股份有限公司	潍柴动力
内蒙古霍林河露天煤业股份有限公司	露天煤业
中信银行股份有限公司	中信银行
深圳拓邦股份有限公司	拓邦股份
交通银行股份有限公司	交通银行
中国铝业股份有限公司	中国铝业
深圳市实益达科技股份有限公司	实益达
深圳顺络电子股份有限公司	顺络电子
深圳市芭田生态工程股份有限公司	芭田股份
东华工程科技股份有限公司	东华科技
中国远洋控股股份有限公司	中国远洋
西部矿业股份有限公司	西部矿业
宏达高科控股股份有限公司	宏达高科
四川高金食品股份有限公司	高金食品
广东蓉胜超微线材股份有限公司	蓉胜超微
宁波银行股份有限公司	宁波银行
南京银行股份有限公司	南京银行
北京中长石基信息技术股份有限公司	石基信息
荣盛房地产发展股份有限公司	荣盛发展
武汉三特索道集团股份有限公司	三特索道
北京北纬通信科技股份有限公司	北纬通信
江苏通润装备科技股份有限公司	江苏通润
广州广电运通金融电子股份有限公司	广电运通
西部金属材料股份有限公司	西部材料
马鞍山方圆回转支承股份有限公司	方圆支承
江西正邦科技股份有限公司	正邦科技
湖南辰州矿业股份有限公司	辰州矿业
北京北斗星通导航技术股份有限公司	北斗星通
南通富士通微电子股份有限公司	通富微电
中核华原钛白股份有限公司	中核钛白
上海汉钟精机股份有限公司	汉钟精机
深圳市惠程电气股份有限公司	深圳惠程
江苏常铝铝业股份有限公司	常铝股份
深圳市远望谷信息技术股份有限公司	远望谷
烟台泰和新材料股份有限公司	泰和新材
浙江报喜鸟服饰股份有限公司	报喜鸟
宁波东力传动设备股份有限公司	东力传动
上海斯米克控股股份有限公司	斯米克
中航三鑫股份有限公司	中航三鑫
广州智光电气股份有限公司	智光电气
广东东方锆业科技股份有限公司	东方锆业
桂林广陆数字测控股份有限公司	广陆数测
安徽精诚铜业股份有限公司	精诚铜业
南京红宝丽股份有限公司	红宝丽
路翔股份有限公司	路翔股份
桂林莱茵生物科技股份有限公司	莱茵生物
江苏澳洋科技股份有限公司	澳洋科技
梅花伞业股份有限公司	梅花伞
北京银行股份有限公司	北京银行
千足珍珠集团股份有限公司	千足珍珠
江西特种电机股份有限公司	江特电机
中航光电科技股份有限公司	中航光电
广州御银科技股份有限公司	御银股份
珠海万力达电气股份有限公司	万力达
中国建设银行股份有限公司	建设银行
上海延华智能科技(集团)股份有限公司	延华智能
中海油田服务股份有限公司	中海油服
深圳市怡亚通供应链股份有限公司	怡亚通
天水华天科技股份有限公司	华天科技
南京云海特种金属股份有限公司	云海金属
上海海得控制系统股份有限公司	海得控制
中国神华能源股份有限公司	中国神华
利达光电股份有限公司	利达光电
中国石油天然气股份有限公司	中国石油
浙江新嘉联电子股份有限公司	新嘉联
广州市广百股份有限公司	广百股份
中国全聚德(集团)股份有限公司	全聚德
浙江方正电机股份有限公司	方正电机
合肥城建发展股份有限公司	合肥城建
山东济宁如意毛纺织股份有限公司	山东如意
四川成飞集成科技股份有限公司	成飞集成
深圳劲嘉彩印集团股份有限公司	劲嘉股份
武汉凡谷电子技术股份有限公司	武汉凡谷
上海海隆软件股份有限公司	海隆软件
北京佳讯飞鸿电气股份有限公司	佳讯飞鸿
云南绿大地生物科技股份有限公司	绿大地
浙江东晶电子股份有限公司	东晶电子
广东嘉应制药股份有限公司	嘉应制药
中国中铁股份有限公司	中国中铁
国投新集能源股份有限公司	国投新集
深圳市证通电子股份有限公司	证通电子
江苏九鼎新材料股份有限公司	九鼎新材
浙江海亮股份有限公司	海亮股份
北方联合出版传媒(集团)股份有限公司	出版传媒
新疆金风科技股份有限公司	金风科技
中海集装箱运输股份有限公司	中海集运
大连华锐重工集团股份有限公司	大连重工
新疆国统管道股份有限公司	国统管道
中国太平洋保险(集团)股份有限公司	中国太保
新疆准东石油技术股份有限公司	准油股份
浙江海利得新材料股份有限公司	海利得
广州达意隆包装机械股份有限公司	达意隆
深圳市飞马国际供应链股份有限公司	飞马国际
江苏宏达新材料股份有限公司	宏达新材
深圳市特尔佳科技股份有限公司	特尔佳
太平洋证券股份有限公司	太平洋
广东南洋电缆集团股份有限公司	南洋股份
三全食品股份有限公司	三全食品
紫金矿业集团股份有限公司	紫金矿业
深圳诺普信农化股份有限公司	诺普信
浙江大立科技股份有限公司	大立科技
安徽江南化工股份有限公司	江南化工
山东联合化工股份有限公司	联合化工
深圳市拓日新能源科技股份有限公司	拓日新能
福建福晶科技股份有限公司	福晶科技
中国中煤能源股份有限公司	中煤能源
东华能源股份有限公司	东华能源
大连天宝绿色食品股份有限公司	天宝股份
三力士股份有限公司	三力士
恒康医疗集团股份有限公司	恒康医疗
金堆城钼业股份有限公司	金钼股份
中国铁建股份有限公司	中国铁建
江苏鱼跃医疗设备股份有限公司	鱼跃医疗
濮阳濮耐高温材料(集团)股份有限公司	濮耐股份
厦门合兴包装印刷股份有限公司	合兴包装
深圳奥特迅电力设备股份有限公司	奥特迅
杭州滨江房产集团股份有限公司	滨江集团
安徽科大讯飞信息科技股份有限公司	科大讯飞
山东恒邦冶炼股份有限公司	恒邦股份
宁波立立电子股份有限公司	立立电子
厦门安妮股份有限公司	安妮股份
启明信息技术股份有限公司	启明信息
奥维通信股份有限公司	奥维通信
中山大洋电机股份有限公司	大洋电机
鸿博股份有限公司	鸿博股份
四川川大智胜软件股份有限公司	川大智胜
山东民和牧业股份有限公司	民和股份
四川北方硝化棉股份有限公司	北化股份
广东塔牌集团股份有限公司	塔牌集团
深圳市通产丽星股份有限公司	通产丽星
浙江大华技术股份有限公司	大华股份
云南西仪工业股份有限公司	西仪股份
上海莱士血液制品股份有限公司	上海莱士
广东威华股份有限公司	威华股份
浙江帝龙新材料股份有限公司	帝龙新材
江苏金飞达服装股份有限公司	金飞达
深圳市天威视讯股份有限公司	天威视讯
九阳股份有限公司	九阳股份
江苏澳洋顺昌股份有限公司	澳洋顺昌
歌尔声学股份有限公司	歌尔声学
威海华东数控股份有限公司	华东数控
浙江大东南股份有限公司	大东南
江苏华昌化工股份有限公司	华昌化工
步步高商业连锁股份有限公司	步步高
深圳市彩虹精细化工股份有限公司	彩虹精化
拓维信息系统股份有限公司	拓维信息
苏州海陆重工股份有限公司	海陆重工
四川升达林业产业股份有限公司	升达林业
江苏恩华药业股份有限公司	恩华药业
新华都购物广场股份有限公司	新华都
广东伊立浦电器股份有限公司	伊立浦
利尔化学股份有限公司	利尔化学
联化科技股份有限公司	联化科技
中国建筑股份有限公司	中国建筑
陕西省天然气股份有限公司	陕天然气
成都卫士通信息产业股份有限公司	卫士通
北京东方雨虹防水技术股份有限公司	东方雨虹
上海美特斯邦威服饰股份有限公司	美邦服饰
山东法因数控机械股份有限公司	法因数控
四川川润股份有限公司	川润股份
浙富控股集团股份有限公司	浙富控股
桂林三金药业股份有限公司	桂林三金
浙江水晶光电科技股份有限公司	水晶光电
福建星网锐捷通讯股份有限公司	星网锐捷
四川成渝高速公路股份有限公司	四川成渝
中国南车股份有限公司	中国南车
光大证券股份有限公司	光大证券
浙江万马电缆股份有限公司	万马电缆
博深工具股份有限公司	博深工具
浙江亚太机电股份有限公司	亚太股份
天润曲轴股份有限公司	天润曲轴
汉王科技股份有限公司	汉王科技
湖南友谊阿波罗商业股份有限公司	友阿股份
上海电气集团股份有限公司	上海电气
上海神开石油化工装备股份有限公司	神开股份
广州珠江啤酒股份有限公司	珠江啤酒
杭州新世纪信息技术股份有限公司	新世纪
深圳世联行地产顾问股份有限公司	世联行
武汉光迅科技股份有限公司	光迅科技
西藏奇正藏药股份有限公司	奇正藏药
保龄宝生物股份有限公司	保龄宝
广东超华科技股份有限公司	超华科技
深圳市宇顺电子股份有限公司	宇顺电子
苏州禾盛新型材料股份有限公司	禾盛新材
河南辉煌科技股份有限公司	辉煌科技
广东精艺金属股份有限公司	精艺股份
佛山星期六鞋业股份有限公司	星期六
福建南平太阳电缆股份有限公司	太阳电缆
广东奥飞动漫文化股份有限公司	奥飞动漫
罗莱家纺股份有限公司	罗莱家纺
深圳信立泰药业股份有限公司	信立泰
招商证券股份有限公司	招商证券
湖南博云新材料股份有限公司	博云新材
北京神州泰岳软件股份有限公司	神州泰岳
北京盛通印刷股份有限公司	盛通股份
北京四方继保自动化股份有限公司	四方股份
长城汽车股份有限公司	长城汽车
二六三网络通信股份有限公司	二六三
二重集团(德阳)重型装备股份有限公司	二重重装
广东盛路通信科技股份有限公司	盛路通信
河南省中原内配股份有限公司	中原内配
江苏神通阀门股份有限公司	江苏神通
山东墨龙石油机械股份有限公司	山东墨龙
天虹商场股份有限公司	天虹商场
北京东土科技股份有限公司	东土科技
安徽鑫龙电器股份有限公司	鑫龙电器
上海超日太阳能科技股份有限公司	超日太阳
中国国旅股份有限公司	中国国旅
福建圣农发展股份有限公司	圣农发展
深圳市齐心文具股份有限公司	齐心文具
浙江永强集团股份有限公司	浙江永强
中国船舶重工股份有限公司	中国重工
江苏洋河酒厂股份有限公司	洋河股份
北京湘鄂情集团股份有限公司	湘鄂情
潜江永安药业股份有限公司	永安药业
中建西部建设股份有限公司	西部建设
新疆北新路桥集团股份有限公司	北新路桥
北京科锐配电自动化股份有限公司	北京科锐
焦点科技股份有限公司	焦点科技
武汉南国置业股份有限公司	南国置业
深圳市美盈森环保科技股份有限公司	美盈森
广东威创视讯科技股份有限公司	威创股份
北京东方园林股份有限公司	东方园林
深圳市燃气集团股份有限公司	深圳燃气
中利科技集团股份有限公司	中利科技
中国北车股份有限公司	中国北车
广东海大集团股份有限公司	海大集团
成都三泰电子实业股份有限公司	三泰电子
株洲天桥起重机股份有限公司	天桥起重
中国冶金科工股份有限公司	中国中冶
深圳日海通讯技术股份有限公司	日海通讯
雅致集成房屋股份有限公司	雅致股份
深圳键桥通讯技术股份有限公司	键桥通讯
深圳浩宁达仪表股份有限公司	浩宁达
中国化学工程股份有限公司	中国化学
浙江久立特材科技股份有限公司	久立特材
深圳市富安娜家居用品股份有限公司	富安娜
广东众生药业股份有限公司	众生药业
珠海市乐通化工股份有限公司	乐通股份
福建榕基软件股份有限公司	榕基软件
河南华英农业发展股份有限公司	华英农业
北京立思辰科技股份有限公司	立思辰
青岛特锐德电气股份有限公司	特锐德
深圳市洪涛装饰股份有限公司	洪涛股份
安徽皖通科技股份有限公司	皖通科技
南方风机股份有限公司	南风股份
上海佳豪船舶工程设计股份有限公司	上海佳豪
乐普(北京)医疗器械股份有限公司	乐普医疗
重庆莱美药业股份有限公司	莱美药业
河南汉威电子股份有限公司	汉威电子
惠州亿纬锂能股份有限公司	亿纬锂能
安徽安科生物工程(集团)股份有限公司	安科生物
北京鼎汉技术股份有限公司	鼎汉技术
北京探路者户外用品股份有限公司	探路者
江苏新宁现代物流股份有限公司	新宁物流
安徽新华传媒股份有限公司	皖新传媒
上海新朋实业股份有限公司	新朋股份
西安宝德自动化股份有限公司	宝德股份
深圳市华测检测技术股份有限公司	华测检测
武汉中元华电科技股份有限公司	中元华电
北京华谊嘉信整合营销顾问集团股份有限公司	华谊嘉信
网宿科技股份有限公司	网宿科技
爱尔眼科医院集团股份有限公司	爱尔眼科
成都硅宝科技股份有限公司	硅宝科技
银江股份有限公司	银江股份
成都金亚科技股份有限公司	金亚科技
吉峰农机连锁股份有限公司	吉峰农机
沈阳新松机器人自动化股份有限公司	机器人
甘肃大禹节水集团股份有限公司	大禹节水
浙江核新同花顺网络信息股份有限公司	同花顺股份
海南海峡航运股份有限公司	海峡股份
浙江正泰电器股份有限公司	正泰电器
华谊兄弟传媒股份有限公司	华谊兄弟
天津红日药业股份有限公司	红日药业
杭州华星创业通信技术股份有限公司	华星创业
上海普利特复合材料股份有限公司	普利特
宁波理工监测科技股份有限公司	理工监测
江苏中联电气股份有限公司	中联电气
浙江永太科技股份有限公司	永太科技
山东得利斯食品股份有限公司	得利斯食品
广西皇氏甲天下乳业股份有限公司	皇氏乳业
苏州罗普斯金铝业股份有限公司	罗普斯金
浙江仙琚制药股份有限公司	仙琚制药
深圳市英威腾电气股份有限公司	英威腾
人人乐连锁商业集团股份有限公司	人人乐
天津赛象科技股份有限公司	赛象科技
厦门科华恒盛股份有限公司	科华恒盛
长春奥普光电技术股份有限公司	奥普光电
深圳市格林美高新技术股份有限公司	格林美
上海徐家汇商城股份有限公司	徐家汇
积成电子股份有限公司	积成电子
深圳市新纶科技股份有限公司	新纶科技
海宁中国皮革城股份有限公司	海宁皮城
无锡宝通带业股份有限公司	宝通带业
北京福星晓程电子科技股份有限公司	福星晓程
巨力索具股份有限公司	巨力索具
安徽省司尔特肥业股份有限公司	司尔特
浙江禾欣实业集团股份有限公司	禾欣股份
广东潮宏基实业股份有限公司	潮宏基
上海柘中建设股份有限公司	柘中建设
泰尔重工股份有限公司	泰尔重工
广东高乐玩具股份有限公司	高乐股份
浙江双箭橡胶股份有限公司	双箭股份
北京钢研高纳科技股份有限公司	钢研高纳
金龙机电股份有限公司	金龙机电
精华制药集团股份有限公司	精华制药
滨化集团股份有限公司	滨化股份
深圳市漫步者科技股份有限公司	漫步者
马鞍山鼎泰稀土新材料股份有限公司	鼎泰新材
江西恒大高新技术股份有限公司	恒大高新
山东兴民钢圈股份有限公司	兴民钢圈
烟台杰瑞石油服务集团股份有限公司	杰瑞股份
江苏华盛天龙光电设备股份有限公司	天龙光电
大连科冕木业股份有限公司	科冕木业
湖南中科电气股份有限公司	中科电气
安徽桑乐金股份有限公司	桑乐金
北京超图软件股份有限公司	超图软件
广州阳普医疗科技股份有限公司	阳普医疗
山东齐星铁塔科技股份有限公司	齐星铁塔
河南森源电气股份有限公司	森源电气
湖南凯美特气体股份有限公司	凯美特气
湖北回天胶业股份有限公司	回天胶业
北京梅泰诺通信技术股份有限公司	梅泰诺
深圳新宙邦科技股份有限公司	新宙邦
四川富临运业集团股份有限公司	富临运业
无锡百川化工股份有限公司	百川股份
浙江亚太药业股份有限公司	亚太药业
浙江亚厦装饰股份有限公司	亚厦股份
华泰证券股份有限公司	华泰证券
深圳市卓翼科技股份有限公司	卓翼科技
哈尔滨九洲电气股份有限公司	九洲电气
赛轮股份有限公司	赛轮股份
山西同德化工股份有限公司	同德化工
杭州中恒电气股份有限公司	中恒电气
上海凯宝药业股份有限公司	上海凯宝
康力电梯股份有限公司	康力电梯
四川丹甫制冷压缩机股份有限公司	丹甫股份
中国西电电气股份有限公司	中国西电
安徽神剑新材料股份有限公司	神剑股份
太极计算机股份有限公司	太极股份
山东丽鹏股份有限公司	丽鹏股份
深圳市朗科科技股份有限公司	朗科科技
北京华力创通科技股份有限公司	华力创通
内蒙古福瑞医疗科技股份有限公司	福瑞股份
深圳天源迪科信息技术股份有限公司	天源迪科
北京七星华创电子股份有限公司	七星电子
北京合康亿盛变频科技股份有限公司	合康变频
北京联信永益科技股份有限公司	联信永益
南京科远自动化集团股份有限公司	科远股份
吉林省集安益盛药业股份有限公司	益盛药业
浙江伟星新型建材股份有限公司	伟星新材
山东新北洋信息技术股份有限公司	新北洋
湖南梦洁家纺股份有限公司	梦洁家纺
中国第一重型机械股份公司	中国一重
崇义章源钨业股份有限公司	章源钨业
珠海世纪鼎利通信科技股份有限公司	世纪鼎利
深圳市赛为智能股份有限公司	赛为智能
湖北台基半导体股份有限公司	台基股份
广东星辉车模股份有限公司	星辉车模
北京合众思壮科技股份有限公司	合众思壮
山东隆基机械股份有限公司	隆基机械
山东鲁丰铝箔股份有限公司	鲁丰股份
山东蓝帆塑胶股份有限公司	蓝帆股份
深圳达实智能股份有限公司	达实智能
深圳海联讯科技股份有限公司	海联讯
厦门三五互联科技股份有限公司	三五互联
北京利尔高温材料股份有限公司	北京利尔
华西能源工业股份有限公司	华西能源
北京大北农科技集团股份有限公司	大北农
苏州东山精密制造股份有限公司	东山精密
宜宾天原集团股份有限公司	天原集团
湖北国创高新材料股份有限公司	国创高新
深圳中青宝互动网络股份有限公司	中青宝
湖北鼎龙化学股份有限公司	鼎龙股份
深圳市佳创视讯技术股份有限公司	佳创视讯
江苏联发纺织股份有限公司	联发股份
天津力生制药股份有限公司	力生制药
重庆水务集团股份有限公司	重庆水务
深圳市新亚电子制程股份有限公司	新亚制程
珠海欧比特控制工程股份有限公司	欧比特
汕头万顺包装材料股份有限公司	万顺股份
北京万邦达环保技术股份有限公司	万邦达
厦门三维丝环保股份有限公司	三维丝
北京蓝色光标品牌管理顾问股份有限公司	蓝色光标
多氟多化工股份有限公司	多氟多
黑牛食品股份有限公司	黑牛食品
无锡双象超纤材料股份有限公司	双象股份
浙江南洋科技股份有限公司	南洋科技
厦门市建筑科学研究院集团股份有限公司	建研集团
贵州信邦制药股份有限公司	信邦制药
江苏长青农化股份有限公司	长青股份
北京昊华能源股份有限公司	昊华能源
深圳市海普瑞药业股份有限公司	海普瑞
广联达软件股份有限公司	广联达
淄博齐翔腾达化工股份有限公司	齐翔腾达
中海网络科技股份有限公司	中海科技
广东省广告股份有限公司	省广股份
浙江嘉欣丝绸股份有限公司	嘉欣丝绸
许昌远东传动轴股份有限公司	远东传动
东方财富信息股份有限公司	东方财富
苏州恒久光电科技股份有限公司	苏州恒久
北京四维图新科技股份有限公司	四维图新
浙江爱仕达电器股份有限公司	爱仕达
深圳和而泰智能控制股份有限公司	和而泰
江苏雅克科技股份有限公司	雅克科技
湖南汉森制药股份有限公司	汉森制药
文峰大世界连锁发展股份有限公司	文峰股份
江苏九九久科技股份有限公司	九九久
上海康耐特光学股份有限公司	康耐特
深圳市爱施德股份有限公司	爱施德
杭州海康威视数字技术股份有限公司	海康威视
武汉高德红外股份有限公司	高德红外
江苏常发制冷股份有限公司	常发股份
高新兴科技集团股份有限公司	高新兴
福建中能电气股份有限公司	中能电气
安徽荃银高科种业股份有限公司	荃银高科
江西三川水表股份有限公司	三川股份
广东太安堂药业股份有限公司	太安堂
福建三元达通讯股份有限公司	三元达
凯撒(中国)股份有限公司	凯撒股份
广东天龙油墨集团股份有限公司	天龙集团
北京海兰信数据科技股份有限公司	海兰信
郑州华晶金刚石股份有限公司	豫金刚石
浙江南都电源动力股份有限公司	南都电源
浙江康盛股份有限公司	康盛股份
广州毅昌科技股份有限公司	毅昌股份
西安陕鼓动力股份有限公司	陕鼓动力
四川科伦药业股份有限公司	科伦药业
中原特钢股份有限公司	中原特钢
云南临沧鑫圆锗业股份有限公司	云南锗业
龙星化工股份有限公司	龙星化工
贵州百灵企业集团制药股份有限公司	贵州百灵
苏州胜利精密制造科技股份有限公司	胜利精密
浙江尤夫高新纤维股份有限公司	尤夫股份
棕榈园林股份有限公司	棕榈园林
深圳欧菲光科技股份有限公司	欧菲光
黑龙江交通发展股份有限公司	龙江交通
吉林高速公路股份有限公司	吉林高速
兰州佛慈制药股份有限公司	佛慈制药
杭州杭氧股份有限公司	杭氧股份
大连壹桥海洋苗业股份有限公司	壹桥苗业
秦皇岛天业通联重工股份有限公司	天业通联
北京当升材料科技股份有限公司	当升科技
北京碧水源科技股份有限公司	碧水源
天津九安医疗电子股份有限公司	九安医疗
深圳市兆驰股份有限公司	兆驰股份
浙江万里扬变速器股份有限公司	万里扬
深圳市兴森快捷电路科技股份有限公司	兴森科技
宁波GQY视讯股份有限公司	宁波GQY
北京三聚环保新材料股份有限公司	三聚环保
烟台龙源电力技术股份有限公司	龙源技术
浙江金利华电气股份有限公司	金利华电
上海安诺其纺织化工股份有限公司	安诺其
长江润发机械股份有限公司	长江润发
浙江闰土股份有限公司	闰土股份
哈尔滨誉衡药业股份有限公司	誉衡药业
浙江金洲管道科技股份有限公司	金洲管道
吉林永大集团股份有限公司	永大集团
河南新大新材料股份有限公司	新大新材
北京数字政通科技股份有限公司	数字政通
洛阳北方玻璃技术股份有限公司	北玻股份
杭州中瑞思创科技股份有限公司	中瑞思创
华平信息技术股份有限公司	华平股份
北京数码视讯科技股份有限公司	数码视讯
东莞劲胜精密组件股份有限公司	劲胜股份
北京启明星辰信息技术股份有限公司	启明星辰
宏昌电子材料股份有限公司	宏昌电子
西安隆基硅材料股份有限公司	隆基股份
国民技术股份有限公司	国民技术
辽宁奥克化学股份有限公司	奥克股份
山东三维石化工程股份有限公司	三维工程
众业达电气股份有限公司	众业达
深圳市方直科技股份有限公司	方直科技
兰州海默科技股份有限公司	海默科技
杭州巨星科技股份有限公司	巨星科技
珠海恒基达鑫国际化工仓储股份有限公司	恒基达鑫
四川天齐锂业股份有限公司	天齐锂业
江阴中南重工股份有限公司	中南重工
广东冠昊生物科技股份有限公司	冠昊生物
海南康芝药业股份有限公司	康芝药业
成都国腾电子技术股份有限公司	国腾电子
海南天然橡胶产业集团股份有限公司	海南橡胶
佛山市国星光电股份有限公司	国星光电
江苏金通灵流体机械科技股份有限公司	金通灵
恒信移动商务股份有限公司	恒信移动
北京康得新复合材料股份有限公司	康得新
山东益生种畜禽股份有限公司	益生股份
上海摩恩电气股份有限公司	摩恩电气
上海开能环保设备股份有限公司	开能环保
芜湖长信科技股份有限公司	长信科技
安徽盛运环保(集团)股份有限公司	盛运股份
易联众信息技术股份有限公司	易联众
宁夏青龙管业股份有限公司	青龙管业
福建海源自动化机械股份有限公司	海源机械
唐山港集团股份有限公司	唐山港
湖南长高高压开关集团股份公司	长高集团
上海加冷松芝汽车空调股份有限公司	松芝股份
苏州天马精细化学品股份有限公司	天马精化
江西赣锋锂业股份有限公司	赣锋锂业
深圳市银之杰科技股份有限公司	银之杰
郑州煤矿机械集团股份有限公司	郑煤机
河南四方达超硬材料股份有限公司	四方达
大连智云自动化装备股份有限公司	智云股份
沪士电子股份有限公司	沪电股份
嘉事堂药业股份有限公司	嘉事堂
尤洛卡矿业安全工程股份有限公司	尤洛卡
广东金刚玻璃科技股份有限公司	金刚玻璃
昆山金利表面材料应用科技股份有限公司	金利科技
际华集团股份有限公司	际华集团
上海金仕达卫宁软件股份有限公司	卫宁软件
湛江国联水产开发股份有限公司	国联水产
广东长城集团股份有限公司	长城集团
深圳市汇川技术股份有限公司	汇川技术
徐州燃控科技股份有限公司	燃控科技
山东同大海岛新材料股份有限公司	同大股份
江西华伍制动器股份有限公司	华伍股份
上海天玑科技股份有限公司	天玑科技
四川科新机电股份有限公司	科新机电
宁波双林汽车部件股份有限公司	双林股份
江苏辉丰农化股份有限公司	辉丰股份
西安达刚路面机械股份有限公司	达刚路机
厦门乾照光电股份有限公司	乾照光电
广州海格通信集团股份有限公司	海格通信
宁波港股份有限公司	宁波港
南通江海电容器股份有限公司	江海股份
上海锐奇工具股份有限公司	锐奇股份
中国农业银行股份有限公司	农业银行
浙江艾迪西流体控制股份有限公司	艾迪西
乐视网信息技术(北京)股份有限公司	乐视网
华仁药业股份有限公司	华仁药业
松德机械股份有限公司	松德股份
山东宝莫生物化工股份有限公司	宝莫股份
山东金正大生态工程股份有限公司	金正大
河北建新化工股份有限公司	建新股份
江苏裕兴薄膜科技股份有限公司	裕兴股份
杭州前进齿轮箱集团股份有限公司	杭齿前进
上海龙宇燃油股份有限公司	龙宇燃油
兴业证券股份有限公司	兴业证券
新疆西部牧业股份有限公司	西部牧业
杭州顺网科技股份有限公司	顺网科技
中航电测仪器股份有限公司	中航电测
深圳万讯自控股份有限公司	万讯自控
浙江华策影视股份有限公司	华策影视
上海泰胜风能装备股份有限公司	泰胜风能
东方日升新能源股份有限公司	东方日升
陕西坚瑞消防股份有限公司	坚瑞消防
博爱新开源制药股份有限公司	新开源
浙江向日葵光能科技股份有限公司	向日葵
北京嘉寓门窗幕墙股份有限公司	嘉寓股份
江苏常宝钢管股份有限公司	常宝股份
江苏中超电缆股份有限公司	中超电缆
天立环保工程股份有限公司	天立环保
深圳市长盈精密技术股份有限公司	长盈精密
通化双龙化工股份有限公司	双龙股份
宁波圣莱达电器股份有限公司	圣莱达
上海新时达电气股份有限公司	新时达
江苏丰东热技术股份有限公司	丰东股份
厦门蒙发利科技(集团)股份有限公司	蒙发利
浙江双环传动机械股份有限公司	双环传动
浙江步森服饰股份有限公司	步森股份
山东豪迈机械科技股份有限公司	豪迈科技
立讯精密工业股份有限公司	立讯精密
中南出版传媒集团股份有限公司	中南传媒
天津经纬电材股份有限公司	经纬电材
苏州锦富新材料股份有限公司	锦富新材
浙江富春江环保热电股份有限公司	富春环保
雏鹰农牧集团股份有限公司	雏鹰农牧
成都市新筑路桥机械股份有限公司	新筑股份
烟台双塔食品股份有限公司	双塔食品
山东阳谷华泰化工股份有限公司	阳谷华泰
天津瑞普生物技术股份有限公司	瑞普生物
中国光大银行股份有限公司	光大银行
大连易世达新能源发展股份有限公司	易世达
上海嘉麟杰纺织品股份有限公司	嘉麟杰
希努尔男装股份有限公司	希努尔
深圳广田装饰集团股份有限公司	广田股份
山西证券股份有限公司	山西证券
齐峰新材料股份有限公司	齐峰新材
太阳鸟游艇股份有限公司	太阳鸟
重庆智飞生物制品股份有限公司	智飞生物
浙江金固股份有限公司	金固股份
辽宁大金重工股份有限公司	大金重工
广东佳隆食品股份有限公司	佳隆食品
浙江哈尔斯真空器皿股份有限公司	哈尔斯
成都银河磁体股份有限公司	银河磁体
九州通医药集团股份有限公司	九州通
深圳科士达科技股份有限公司	科士达
荣盛石化股份有限公司	荣盛石化
江苏通鼎光电股份有限公司	通鼎光电
江苏玉龙钢管股份有限公司	玉龙股份
江苏润邦重工股份有限公司	润邦股份
深圳市大富科技股份有限公司	大富科技
深圳市新国都技术股份有限公司	新国都
江苏宝利沥青股份有限公司	宝利沥青
海伦钢琴股份有限公司	海伦钢琴
四川雅化实业集团股份有限公司	雅化集团
华斯农业开发股份有限公司	华斯股份
广西丰林木业集团股份有限公司	丰林集团
深圳市英唐智能控制股份有限公司	英唐智控
青岛汉缆股份有限公司	汉缆股份
河北先河环保科技股份有限公司	先河环保
福建青松股份有限公司	青松股份
烟台万润精细化工股份有限公司	烟台万润
晨光生物科技集团股份有限公司	晨光生物
深圳市信维通信股份有限公司	信维通信
云南沃森生物技术股份有限公司	沃森生物
科林环保装备股份有限公司	科林环保
吉林利源精制股份有限公司	利源精制
骅威科技股份有限公司	骅威股份
苏州工业园区和顺电气股份有限公司	和顺电气
西安启源机电装备股份有限公司	启源股份
中顺洁柔纸业股份有限公司	中顺洁柔
天津汽车模具股份有限公司	天汽模
湖南大康牧业股份有限公司	大康牧业
江苏东光微电子股份有限公司	东光微电
华油惠博普科技股份有限公司	惠博普
杭州老板电器股份有限公司	老板电器
深圳市瑞凌实业股份有限公司	瑞凌股份
苏州苏大维格光电科技股份有限公司	苏大维格
天广消防股份有限公司	天广消防
东莞市搜于特服装股份有限公司	搜于特
杭州宋城旅游发展股份有限公司	宋城股份
广东星河生物科技股份有限公司	星河生物
江苏德威新材料股份有限公司	德威新材
苏州宝馨科技实业股份有限公司	宝馨科技
重庆市涪陵榨菜集团股份有限公司	涪陵榨菜
江苏蓝丰生物化工股份有限公司	蓝丰生化
力帆实业(集团)股份有限公司	力帆股份
大连港股份有限公司	大连港
金字火腿股份有限公司	金字火腿
南方泵业股份有限公司	南方泵业
天舟文化股份有限公司	天舟文化
浙江日发精密机械股份有限公司	日发精机
中山达华智能科技股份有限公司	达华智能
万达信息股份有限公司	万达信息
山西振东制药股份有限公司	振东制药
江苏旷达汽车织物集团股份有限公司	江苏旷达
泰亚鞋业股份有限公司	泰亚股份
渤海轮渡股份有限公司	渤海轮渡
江苏银河电子股份有限公司	银河电子
华锐风电科技(集团)股份有限公司	华锐风电
湖南胜景山河生物科技股份有限公司	胜景山河
恒泰艾普石油天然气技术服务股份有限公司	恒泰艾普
浙江众成包装材料股份有限公司	浙江众成
汤臣倍健股份有限公司	汤臣倍健
量子高科(中国)生物股份有限公司	NULL
苏州春兴精工股份有限公司	春兴精工
广东安居宝数码科技股份有限公司	安居宝
深圳市昌红科技股份有限公司	昌红科技
大连电瓷集团股份有限公司	大连电瓷
光正集团股份有限公司	光正集团
深圳英飞拓科技股份有限公司	英飞拓
广州市香雪制药股份有限公司	香雪制药
上海科泰电源股份有限公司	科泰电源
山东矿机集团股份有限公司	山东矿机
新界泵业集团股份有限公司	新界泵业
杭州锅炉集团股份有限公司	杭锅股份
天顺风能(苏州)股份有限公司	天顺风能
常州天晟新材料股份有限公司	天晟新材
深圳雷曼光电科技股份有限公司	雷曼光电
武汉华中数控股份有限公司	华中数控
江苏亚太轻合金科技股份有限公司	亚太科技
海欣食品股份有限公司	海欣食品
唐人神集团股份有限公司	唐人神
永辉超市股份有限公司	永辉超市
潜能恒信能源技术股份有限公司	潜能恒信
新疆机械研究院股份有限公司	新研股份
江苏天瑞仪器股份有限公司	天瑞仪器
北京君正集成电路股份有限公司	北京君正
林州重机集团股份有限公司	林州重机
深圳市捷顺科技实业股份有限公司	捷顺科技
西安通源石油科技股份有限公司	通源石油
宁波先锋新材料股份有限公司	先锋新材
江苏秀强玻璃工艺股份有限公司	秀强股份
河南省西峡汽车水泵股份有限公司	西泵股份
洽洽食品股份有限公司	洽洽食品
成都市新都化工股份有限公司	新都化工
江苏亚星锚链股份有限公司	亚星锚链
金杯电工股份有限公司	金杯电工
上海汉得信息技术股份有限公司	汉得信息
福建元力活性炭股份有限公司	元力股份
北京东方国信科技股份有限公司	东方国信
深圳市迪威视讯股份有限公司	迪威视讯
青岛海立美达股份有限公司	海立美达
南京中电环保股份有限公司	中电环保
上海东富龙科技股份有限公司	东富龙
福安药业(集团)股份有限公司	福安药业
朗源股份有限公司	朗源股份
上海华峰超纤材料股份有限公司	华峰超纤
青岛东方铁塔股份有限公司	东方铁塔
常州千红生化制药股份有限公司	千红制药
广州杰赛科技股份有限公司	杰赛科技
安徽鸿路钢结构(集团)股份有限公司	鸿路钢构
三江购物俱乐部股份有限公司	三江购物
浙江贝因美科工贸股份有限公司	贝因美
深圳市尚荣医疗股份有限公司	尚荣医疗
广州中海达卫星导航技术股份有限公司	中海达
深圳市腾邦国际商业服务股份有限公司	腾邦国际
广东鸿特精密技术股份有限公司	广东鸿特
中化岩土工程股份有限公司	中化岩土
浙江佐力药业股份有限公司	佐力药业
常熟风范电力设备股份有限公司	风范股份
宁波博威合金材料股份有限公司	博威合金
湖南千山制药机械股份有限公司	千山药机
深圳市佳士科技股份有限公司	佳士科技
青岛东软载波科技股份有限公司	东软载波
深圳市铁汉生态环境股份有限公司	铁汉生态
广东万和新电气股份有限公司	万和电气
上海大智慧股份有限公司	大智慧
宝鼎重工股份有限公司	宝鼎重工
南京新联电子股份有限公司	新联电子
常州星宇车灯股份有限公司	星宇股份
武汉力源信息技术股份有限公司	力源信息
北京捷成世纪科技股份有限公司	捷成股份
上海广电电气(集团)股份有限公司	广电电气
江门市科恒实业股份有限公司	科恒股份
聚光科技(杭州)股份有限公司	聚光科技
重庆新世纪游轮股份有限公司	世纪游轮
芜湖顺荣汽车部件股份有限公司	顺荣股份
深圳市金新农饲料股份有限公司	金新农
北京拓尔思信息技术股份有限公司	拓尔思
江苏亚威机床股份有限公司	亚威股份
内蒙古君正能源化工股份有限公司	内蒙君正
宁波建工股份有限公司	宁波建工
江苏南方轴承股份有限公司	南方轴承
武汉天喻信息产业股份有限公司	天喻信息
武汉金运激光股份有限公司	金运激光
福建纳川管材科技股份有限公司	纳川股份
厦门市美亚柏科信息股份有限公司	美亚柏科
天津长荣印刷设备股份有限公司	长荣股份
广东大华农动物保健品股份有限公司	大华农
江苏长海复合材料股份有限公司	长海股份
永清环保股份有限公司	永清环保
湖南红宇耐磨新材料股份有限公司	红宇新材
通裕重工股份有限公司	通裕重工
安徽辉隆农资集团股份有限公司	辉隆股份
江苏维尔利环保科技股份有限公司	维尔利
七台河宝泰隆煤化工股份有限公司	宝泰隆
河南通达电缆股份有限公司	通达股份
庞大汽贸集团股份有限公司	庞大集团
上海绿新包装材料科技股份有限公司	上海绿新
深圳雷柏科技股份有限公司	雷柏科技
江苏亿通高科技股份有限公司	亿通科技
苏州科斯伍德油墨股份有限公司	科斯伍德
海南神农大丰种业科技股份有限公司	神农大丰
北京金隅股份有限公司	金隅股份
浙江森马服饰股份有限公司	森马服饰
江苏江南水务股份有限公司	江南水务
舒泰神(北京)生物制药股份有限公司	舒泰神
山东日科化学股份有限公司	日科化学
深圳翰宇药业股份有限公司	翰宇药业
北京高盟新材料股份有限公司	高盟新材
兄弟科技股份有限公司	兄弟科技
张家港化工机械股份有限公司	张化机
安徽德力日用玻璃股份有限公司	德力股份
上海百润香精香料股份有限公司	百润股份
徐州海伦哲专用车辆股份有限公司	海伦哲
惠州中京电子科技股份有限公司	中京电子
淄博万昌科技股份有限公司	万昌科技
江苏吉鑫风能科技股份有限公司	吉鑫科技
索菲亚家居股份有限公司	索菲亚
北京国电清新环保技术股份有限公司	国电清新
浙江明牌珠宝股份有限公司	明牌珠宝
江苏通达动力科技股份有限公司	通达动力
广东群兴玩具股份有限公司	群兴玩具
北京汇冠新技术股份有限公司	汇冠股份
辽宁聚龙金融设备股份有限公司	聚龙股份
深圳市理邦精密仪器股份有限公司	理邦仪器
鞍山森远路桥股份有限公司	森远股份
青岛市恒顺电气股份有限公司	恒顺电气
天泽信息产业股份有限公司	天泽信息
山东圣阳电源股份有限公司	圣阳股份
九牧王股份有限公司	九牧王
义乌华鼎锦纶股份有限公司	华鼎锦纶
福建省闽发铝业股份有限公司	闽发铝业
欣旺达电子股份有限公司	欣旺达
北京易华录信息技术股份有限公司	易华录
桐昆集团股份有限公司	桐昆股份
四川东材科技集团股份有限公司	东材科技
安徽安利合成革股份有限公司	安利股份
西陇化工股份有限公司	西陇化工
好想你枣业股份有限公司	好想你
江苏林洋电子股份有限公司	林洋电子
上海金力泰化工股份有限公司	金力泰
苏州电器科学研究院股份有限公司	电科院
浙江开山压缩机股份有限公司	开山股份
广州市鸿利光电股份有限公司	鸿利光电
科大智能科技股份有限公司	科大智能
镇江东方电热科技股份有限公司	东方电热
广东银禧科技股份有限公司	银禧科技
海能达通信股份有限公司	海能达
江苏鹿港科技股份有限公司	鹿港科技
浙江万安科技股份有限公司	万安科技
北京银信长远科技股份有限公司	银信科技
南宁八菱科技股份有限公司	八菱科技
深圳光韵达光电科技股份有限公司	光韵达
烟台正海磁性材料股份有限公司	正海磁材
张家港富瑞特种装备股份有限公司	富瑞特装
四川依米康环境科技股份有限公司	依米康
上海钢联电子商务股份有限公司	上海钢联
江苏飞力达国际物流股份有限公司	飞力达
江苏双星彩塑新材料股份有限公司	双星新材
骆驼集团股份有限公司	骆驼股份
浙江省围海建设集团股份有限公司	围海股份
上海永利带业股份有限公司	永利带业
深圳市洲明科技股份有限公司	洲明科技
浙江开尔新材料股份有限公司	开尔新材
甘肃蓝科石化高新装备股份有限公司	蓝科高新
山东瑞康医药股份有限公司	瑞康医药
深圳市奥拓电子股份有限公司	奥拓电子
山东金城医药化工股份有限公司	金城医药
上海新阳半导体材料股份有限公司	上海新阳
山东美晨科技股份有限公司	美晨科技
史丹利化肥股份有限公司	史丹利
宁波三星电气股份有限公司	三星电气
上海姚记扑克股份有限公司	姚记扑克
比亚迪股份有限公司	比亚迪
山东龙力生物科技股份有限公司	龙力生物
包头东宝生物技术股份有限公司	东宝生物
厦门日上车轮集团股份有限公司	日上集团
海南瑞泽新型建材股份有限公司	海南瑞泽
厦门金达威集团股份有限公司	金达威
广东江粉磁材股份有限公司	江粉磁材
河南佰利联化学股份有限公司	佰利联
安徽金禾实业股份有限公司	金禾实业
山东省章丘鼓风机股份有限公司	山东章鼓
广东明家科技股份有限公司	明家科技
江苏太平洋精锻科技股份有限公司	精锻科技
深圳市瑞丰光电子股份有限公司	瑞丰光电
方正证券股份有限公司	方正证券
芜湖亚夏汽车股份有限公司	亚夏汽车
浙江世纪华通车业股份有限公司	世纪华通
山东瑞丰高分子材料股份有限公司	瑞丰高材
浙江迪安诊断技术股份有限公司	迪安诊断
石家庄以岭药业股份有限公司	以岭药业
郑州新开普电子股份有限公司	新开普
杭州初灵信息技术股份有限公司	初灵信息
广东宝莱特医用科技股份有限公司	宝莱特
深圳瑞和建筑装饰股份有限公司	瑞和股份
北京光线传媒股份有限公司	光线传媒
湖北宜昌交运集团股份有限公司	宜昌交运
江苏舜天船舶股份有限公司	舜天船舶
山西仟源制药股份有限公司	仟源制药
浙江星星瑞金科技股份有限公司	星星科技
河北常山生化药业股份有限公司	常山药业
株洲旗滨集团股份有限公司	旗滨集团
昆山新莱洁净应用材料股份有限公司	新莱应材
深圳金信诺高新技术股份有限公司	金信诺
深圳丹邦科技股份有限公司	丹邦科技
江苏通光电子线缆股份有限公司	通光线缆
湖南尔康制药股份有限公司	尔康制药
新天科技股份有限公司	新天科技
深圳市聚飞光电股份有限公司	聚飞光电
四川仁智油田技术服务股份有限公司	仁智油服
江苏爱康科技股份有限公司	爱康科技
江苏省交通科学研究院股份有限公司	苏交科
北京京运通科技股份有限公司	京运通
江河创建集团股份有限公司	江河创建
深圳市联建光电股份有限公司	联建光电
珠海和佳医疗设备股份有限公司	和佳股份
雅本化学股份有限公司	雅本化学
广东东方精工科技股份有限公司	东方精工
万福生科(湖南)农业开发股份有限公司	万福生科
洛阳隆华传热节能股份有限公司	隆华节能
江西博雅生物制药股份有限公司	博雅生物
广东长青(集团)股份有限公司	长青集团
上海巴安水务股份有限公司	巴安水务
杭州中威电子股份有限公司	中威电子
河南明泰铝业股份有限公司	明泰铝业
朗姿股份有限公司	朗姿股份
浙江金磊高温材料股份有限公司	金磊股份
大连三垒机器股份有限公司	大连三垒
浙江巨龙管业股份有限公司	巨龙管业
永高股份有限公司	永高股份
露笑科技股份有限公司	露笑科技
杭州兴源过滤科技股份有限公司	兴源过滤
中国电力建设股份有限公司	中国电建
阳光电源股份有限公司	阳光电源
江苏恒立高压油缸股份有限公司	恒立油缸
温州宏丰电工合金股份有限公司	温州宏丰
重庆梅安森科技股份有限公司	梅安森
成都市路桥工程股份有限公司	成都路桥
浙江龙生汽车部件股份有限公司	龙生股份
常州亚玛顿股份有限公司	亚玛顿
浙江赞宇科技股份有限公司	赞宇科技
金安国纪科技股份有限公司	金安国纪
东吴证券股份有限公司	东吴证券
湖北华昌达智能装备股份有限公司	华昌达
浙江棒杰数码针织品股份有限公司	棒杰股份
山西百圆裤业连锁经营股份有限公司	百圆裤业
德尔国际家居股份有限公司	德尔家居
申科滑动轴承股份有限公司	申科股份
湖北三丰智能输送装备股份有限公司	三丰智能
南通锻压设备股份有限公司	南通锻压
浙江奥康鞋业股份有限公司	奥康国际
中国交通建设股份有限公司	中国交建
苏州安洁科技股份有限公司	安洁科技
沈阳蓝英工业自动化装备股份有限公司	蓝英装备
道明光学股份有限公司	道明光学
浙江卫星石化股份有限公司	卫星石化
无锡和晶科技股份有限公司	和晶科技
青海互助青稞酒股份有限公司	青青稞酒
福建雪人股份有限公司	雪人股份
江苏华宏科技股份有限公司	华宏科技
山东国瓷功能材料股份有限公司	国瓷材料
广东金明精机股份有限公司	金明精机
江苏凤凰出版传媒股份有限公司	凤凰传媒
西部证券股份有限公司	西部证券
东莞勤上光电股份有限公司	勤上光电
浙江宏磊铜业股份有限公司	宏磊股份
安科瑞电气股份有限公司	安科瑞
江苏三六五网络股份有限公司	三六五网
贵阳朗玛信息技术股份有限公司	朗玛信息
广东奥马电器股份有限公司	奥马电器
北京荣之联科技股份有限公司	荣之联
成都利君实业股份有限公司	利君股份
北京旋极信息技术股份有限公司	旋极信息
深圳市华鹏飞现代物流股份有限公司	华鹏飞
北京飞利信科技股份有限公司	飞利信
荣科科技股份有限公司	荣科科技
江南嘉捷电梯股份有限公司	江南嘉捷
博彦科技股份有限公司	博彦科技
信质电机股份有限公司	信质电机
三诺生物传感股份有限公司	三诺生物
山东共达电声股份有限公司	共达电声
广州卡奴迪路服饰股份有限公司	卡奴迪路
新华人寿保险股份有限公司	新华保险
鞍山重型矿山机器股份有限公司	鞍重股份
北京利德曼生化股份有限公司	利德曼
北京威卡威汽车零部件股份有限公司	京威股份
金河生物科技股份有限公司	金河生物
北京华录百纳影视股份有限公司	华录百纳
苏州扬子江新型材料股份有限公司	扬子新材
蓝盾信息安全技术股份有限公司	蓝盾股份
加加食品集团股份有限公司	加加食品
江苏吴通通讯股份有限公司	吴通通讯
广东德联集团股份有限公司	德联集团
吉视传媒股份有限公司	吉视传媒
广东宜通世纪科技股份有限公司	宜通世纪
宁波慈星股份有限公司	慈星股份
深圳万润科技股份有限公司	万润科技
西藏海思科药业集团股份有限公司	海思科
百隆东方股份有限公司	百隆东方
吉艾科技(北京)股份公司(2013-05-17后)	吉艾科技
深圳市长方半导体照明股份有限公司	长方照明
利亚德光电股份有限公司	利亚德
江苏云意电气股份有限公司	云意电气
杭州远方光电信息股份有限公司	远方光电
东江环保股份有限公司	东江环保
广州普邦园林股份有限公司	普邦园林
怡球金属资源再生(中国)股份有限公司	怡球资源
汕头东风印刷股份有限公司	东风股份
上海凯利泰医疗科技股份有限公司	凯利泰
环旭电子股份有限公司	环旭电子
北京中科金财科技股份有限公司	中科金财
汉鼎信息科技股份有限公司	汉鼎股份
茂硕电源科技股份有限公司	茂硕电源
上海康达化工新材料股份有限公司	康达新材
北京雪迪龙科技股份有限公司	雪迪龙
兴业皮革科技股份有限公司	兴业科技
克明面业股份有限公司	克明面业
江苏中泰桥梁钢构股份有限公司	中泰桥梁
江阴海达橡塑股份有限公司	海达股份
新疆天山畜牧生物工程股份有限公司	天山生物
宁波戴维医疗器械股份有限公司	戴维医疗
广东华声电器股份有限公司	华声股份
北京翠微大厦股份有限公司	翠微股份
中颖电子股份有限公司	中颖电子
中国汽车工程研究院股份有限公司	中汽院
四川明星电缆股份有限公司	明星电缆
烟台东诚生化股份有限公司	东诚生化
任子行网络技术股份有限公司	任子行
浙江美大实业股份有限公司	浙江美大
广东顺威精密塑料股份有限公司	顺威股份
北京同有飞骥科技股份有限公司	同有科技
山东中际电工装备股份有限公司	中际装备
上海华虹计通智能系统股份有限公司	华虹计通
第一拖拉机股份有限公司	一拖股份
深圳珈伟光伏照明股份有限公司	珈伟股份
邦讯技术股份有限公司	邦讯技术
北京掌趣科技股份有限公司	掌趣科技
富春通信股份有限公司	富春通信
人民网股份有限公司	人民网
港中旅华贸国际物流股份有限公司	华贸物流
山东龙泉管道工程股份有限公司	龙泉股份
北京首航艾启威节能技术股份有限公司	首航节能
百洋水产集团股份有限公司	百洋股份
美盛文化创意股份有限公司	美盛文化
无锡华东重型机械股份有限公司	华东重机
福建龙洲运输股份有限公司	龙洲股份
四川和邦股份有限公司	和邦股份
远程电缆股份有限公司	远程电缆
浙江晶盛机电股份有限公司	晶盛机电
深圳市麦捷微电子科技股份有限公司	麦捷科技
日出东方太阳能股份有限公司	日出东方
合肥美亚光电技术股份有限公司	美亚光电
广州珠江钢琴集团股份有限公司	珠江钢琴
石家庄中煤装备制造股份有限公司	石中装备
常熟市天银机电股份有限公司	天银机电
惠州硕贝德无线科技股份有限公司	硕贝德
江苏润和软件股份有限公司	润和软件
深圳兆日科技股份有限公司	兆日科技
福建金森林业股份有限公司	福建金森
沈阳博林特电梯集团股份有限公司	沈阳博林特电梯
上海新文化传媒集团股份有限公司	新文化
喜临门家具股份有限公司	喜临门
天津膜天膜科技股份有限公司	津膜科技
深圳市长亮科技股份有限公司	NULL
长沙开元仪器股份有限公司	开元仪器
奥瑞金包装股份有限公司	奥瑞金
锦州新华龙钼业股份有限公司	新华龙
银邦金属复合材料股份有限公司	银邦股份
浙江乔治白服饰股份有限公司	乔治白
顾地科技股份有限公司	顾地科技
连云港黄海机械股份有限公司	黄海机械
天壕节能科技股份有限公司	天壕节能
东莞宜安科技股份有限公司	宜安科技
金卡高科技股份有限公司	金卡股份
北京太空板业股份有限公司	太空板业
哈尔滨博实自动化股份有限公司	博实股份
华灿光电股份有限公司	华灿光电
广州迪森热能技术股份有限公司	迪森股份
隆鑫通用动力股份有限公司	隆鑫通用
杭州泰格医药科技股份有限公司	泰格医药
麦克奥迪(厦门)电气股份有限公司	麦迪电气
深圳市奋达科技股份有限公司	奋达科技
浙江亿利达风机股份有限公司	亿利达
广东宏大爆破股份有限公司	宏大爆破
江苏南大光电材料股份有限公司	南大光电
山东联创节能新材料股份有限公司	联创节能
广东猛狮电源科技股份有限公司	猛狮科技
海南双成药业股份有限公司	双成药业
洛阳栾川钼业集团股份有限公司	洛阳钼业
中信重工机械股份有限公司	中信重工
广州汽车集团股份有限公司	广汽集团
北京北信源软件股份有限公司	北信源
江西煌上煌集团食品股份有限公司	煌上煌
浙江世宝股份有限公司	浙江世宝
光一科技股份有限公司	光一科技
江苏东华测试技术股份有限公司	东华测试
新疆浩源天然气股份有限公司	新疆浩源
浙江永贵电器股份有限公司	永贵电器
内蒙古和信园蒙草抗旱绿化股份有限公司	蒙草抗旱
成都红旗连锁股份有限公司	红旗连锁
美的集团股份有限公司	美的股份
创智信息科技股份有限公司	创智科技
浙江浙能电力股份有限公司	浙能电力
